"","State","Weather_Type","Fatalities","Injuries","Property_Damage","Crop_Damage","Total_Damage","Total_Casualties"
"1","AK","",0,0,0,0,0,0
"2","AK","AVALANCHE",33,17,869000,0,869000,50
"3","AK","BLIZZARD",7,5,201000,0,201000,12
"4","AK","DROUGHT",0,0,0,0,0,0
"5","AK","DRY",0,0,0,0,0,0
"6","AK","DUST DEVIL",0,0,2300,0,2300,0
"7","AK","FLOOD",6,0,193025000,8000,193033000,6
"8","AK","FREEZE",0,0,5000,0,5000,0
"9","AK","FROST FREEZE",0,0,0,0,0,0
"10","AK","FUNNEL CLOUD",0,0,0,0,0,0
"11","AK","HAIL",0,0,15000,0,15000,0
"12","AK","HEAT",1,0,0,0,0,1
"13","AK","ICE JAM FLOOD",0,0,1000,0,1000,0
"14","AK","ICE STORM",5,34,336000,10000,346000,39
"15","AK","LAND SLIDE",0,0,2051000,0,2051000,0
"16","AK","LIGHTNING",0,3,1000,0,1000,3
"17","AK","MISHAP",7,5,0,0,0,12
"18","AK","OTHER",0,0,50000,0,50000,0
"19","AK","RAIN",0,0,3868000,0,3868000,0
"20","AK","SEICHE",0,0,750000,0,750000,0
"21","AK","SMOKE",0,0,0,0,0,0
"22","AK","SNOW",4,16,1387750,10000,1397750,20
"23","AK","STORM",0,2,24947000,0,24947000,2
"24","AK","SURF",0,0,7150000,0,7150000,0
"25","AK","TEMPERATURE",0,0,0,0,0,0
"26","AK","TEMPERATURE_HIGH",0,0,0,0,0,0
"27","AK","TEMPERATURE_LOW",2,1,256000,0,256000,3
"28","AK","THUNDERSNOW SHOWER",0,0,0,0,0,0
"29","AK","THUNDERSTORM WIND",0,0,2528000,0,2528000,0
"30","AK","TIDE",1,1,500,0,500,2
"31","AK","TORNADO",0,0,0,0,0,0
"32","AK","TURBULENCE",0,0,50000,0,50000,0
"33","AK","VOLCANIC ASH",0,0,0,0,0,0
"34","AK","VOLCANIC ERUPTION",0,0,0,0,0,0
"35","AK","WATERSPOUT",0,0,0,0,0,0
"36","AK","WILD FIRE",0,9,15190000,10000,15200000,9
"37","AK","WIND",5,18,44951750,167000,45118750,23
"38","AK","WINTER STORM",2,0,36000,0,36000,2
"39","AK","WINTER WEATHER",1,1,80000,0,80000,2
"40","AL","DROUGHT",0,0,0,1e+05,1e+05,0
"41","AL","DUST DEVIL",0,0,25000,0,25000,0
"42","AL","FLOOD",19,15,471094500,21886000,492980500,34
"43","AL","FOG",1,91,1500000,0,1500000,92
"44","AL","FREEZE FOG",0,0,0,0,0,0
"45","AL","FREEZE RAIN",0,0,10000,0,10000,0
"46","AL","FROST FREEZE",0,0,0,0,0,0
"47","AL","FUNNEL",0,0,0,0,0,0
"48","AL","FUNNEL CLOUD",0,0,0,0,0,0
"49","AL","HAIL",0,1,22008550,1059000,23067550,1
"50","AL","HEAT",22,73,0,400100000,400100000,95
"51","AL","HURRICANE",4,0,449345000,57600000,506945000,4
"52","AL","ICE STORM",1,2,18857000,0,18857000,3
"53","AL","LAND SLIDE",0,0,129000,0,129000,0
"54","AL","LIGHTING",0,0,33000,0,33000,0
"55","AL","LIGHTNING",28,154,29412350,16240,29428590,182
"56","AL","RAIN",5,9,55699500,5450000,61149500,14
"57","AL","RIP CURRENT",26,4,0,0,0,30
"58","AL","SLEET",0,0,0,0,0,0
"59","AL","SNOW",0,0,300,0,300,0
"60","AL","STORM",0,0,4400000,0,4400000,0
"61","AL","SURF",0,0,8103000,0,8103000,0
"62","AL","TEMPERATURE_LOW",9,0,0,5.2e+07,5.2e+07,9
"63","AL","THUNDERSTORM",0,0,0,0,0,0
"64","AL","THUNDERSTORM WIND",40,431,115400050,10035500,125435550,471
"65","AL","TORNADO",617,7929,3821297560,56797500,3878095060,8546
"66","AL","TROPICAL DEPRESSION",0,0,7000,0,7000,0
"67","AL","TROPICAL STORM",0,11,52845000,0,52845000,11
"68","AL","WALL CLOUD",0,0,0,0,0,0
"69","AL","WALL CLOUD FUNNEL CLOUD",0,0,0,0,0,0
"70","AL","WATERSPOUT",0,0,1000,0,1000,0
"71","AL","WILD FIRE",0,0,103000,0,103000,0
"72","AL","WIND",6,20,89148100,1367000,90515100,26
"73","AL","WINTER STORM",6,2,2033000,358000,2391000,8
"74","AL","WINTER WEATHER",0,0,10000,0,10000,0
"75","AM","HAIL",0,0,0,0,0,0
"76","AM","THUNDERSTORM WIND",9,30,551800,50000,601800,39
"77","AM","WATERSPOUT",0,0,5102000,0,5102000,0
"78","AM","WIND",1,0,0,0,0,1
"79","AN","HAIL",0,0,4000,0,4000,0
"80","AN","THUNDERSTORM WIND",7,3,189000,0,189000,10
"81","AN","WATERSPOUT",0,1,16000,0,16000,1
"82","AN","WIND",5,19,85000,0,85000,24
"83","AR","DROUGHT",0,0,0,2650000,2650000,0
"84","AR","DUST STORM",0,0,0,0,0,0
"85","AR","FLOOD",61,42,634426080,150090000,784516080,103
"86","AR","FOG",0,0,0,0,0,0
"87","AR","FREEZE FOG",0,0,0,0,0,0
"88","AR","FREEZE RAIN",0,0,0,0,0,0
"89","AR","FROST FREEZE",0,0,0,3e+05,3e+05,0
"90","AR","FUNNEL CLOUD",0,0,0,0,0,0
"91","AR","HAIL",0,52,227407060,9463000,236870060,52
"92","AR","HEAT",35,7,0,0,0,42
"93","AR","HURRICANE",0,0,750000,7700000,8450000,0
"94","AR","ICE STORM",4,0,687091000,0,687091000,4
"95","AR","LAND SLIDE",0,0,75000,0,75000,0
"96","AR","LIGHTNING",14,79,33013110,0,33013110,93
"97","AR","RAIN",2,1,2835000,1e+06,3835000,3
"98","AR","SNOW",0,0,50814060,20000,50834060,0
"99","AR","TEMPERATURE_HIGH",0,0,0,0,0,0
"100","AR","TEMPERATURE_LOW",3,0,0,750000,750000,3
"101","AR","THUNDERSTORM WIND",22,237,123746210,1e+05,123846210,259
"102","AR","TORNADO",379,5116,2590007310,1507010,2591514320,5495
"103","AR","TROPICAL DEPRESSION",0,0,1e+06,0,1e+06,0
"104","AR","TROPICAL STORM",0,1,2608000,2e+05,2808000,1
"105","AR","WATERSPOUT",0,0,0,0,0,0
"106","AR","WILD FIRE",0,4,8220000,1010000,9230000,4
"107","AR","WIND",8,8,3419500,0,3419500,16
"108","AR","WINTER STORM",1,2,16864040,0,16864040,3
"109","AR","WINTER WEATHER",1,1,30000,0,30000,2
"110","AS","DROUGHT",0,0,0,0,0,0
"111","AS","FLOOD",4,6,50994000,1267000,52261000,10
"112","AS","FUNNEL CLOUD",0,0,0,0,0,0
"113","AS","HURRICANE",0,20,60550000,602000,61152000,20
"114","AS","LAND SLIDE",0,0,75000,0,75000,0
"115","AS","LIGHTNING",1,1,120000,0,120000,2
"116","AS","RAIN",0,0,50000,10000,60000,0
"117","AS","RIP CURRENT",36,131,81020000,20000,81040000,167
"118","AS","SURF",0,6,3865000,0,3865000,6
"119","AS","TROPICAL DEPRESSION",0,0,0,0,0,0
"120","AS","TROPICAL STORM",0,0,5e+05,5e+05,1e+06,0
"121","AS","WIND",0,0,86000,164000,250000,0
"122","AZ","AVALANCHE",0,0,0,0,0,0
"123","AZ","BLIZZARD",0,0,0,0,0,0
"124","AZ","DROUGHT",0,0,0,0,0,0
"125","AZ","DRY MICROBURST",0,1,5000,0,5000,1
"126","AZ","DUST DEVIL",0,8,68500,0,68500,8
"127","AZ","DUST STORM",15,179,2238000,0,2238000,194
"128","AZ","FLOOD",63,159,120584100,13515000,134099100,222
"129","AZ","FOG",0,18,0,0,0,18
"130","AZ","FROST FREEZE",0,0,2e+06,3e+05,2300000,0
"131","AZ","FUNNEL CLOUD",0,0,0,0,0,0
"132","AZ","HAIL",1,8,1028908700,151000,1029059700,9
"133","AZ","HEAT",58,0,0,0,0,58
"134","AZ","ICE STORM",5,0,110000,0,110000,5
"135","AZ","LAND SLIDE",0,0,10000,0,10000,0
"136","AZ","LIGHTNING",18,98,8853750,0,8853750,116
"137","AZ","OTHER",0,0,5000,0,5000,0
"138","AZ","RAIN",1,3,6495000,0,6495000,4
"139","AZ","SLEET",2,0,0,0,0,2
"140","AZ","SMOKE",0,0,0,0,0,0
"141","AZ","SNOW",3,45,105000,0,105000,48
"142","AZ","TEMPERATURE_LOW",0,0,0,0,0,0
"143","AZ","THUNDERSTORM WIND",11,189,489467300,165000,489632300,200
"144","AZ","TORNADO",3,147,47975330,30000,48005330,150
"145","AZ","TROPICAL STORM",0,0,0,2e+08,2e+08,0
"146","AZ","WATERSPOUT",0,0,0,0,0,0
"147","AZ","WILD FIRE",0,14,222715000,0,222715000,14
"148","AZ","WIND",11,24,16179000,0,16179000,35
"149","AZ","WINTER STORM",17,20,120000,0,120000,37
"150","AZ","WINTER WEATHER",0,55,530000,0,530000,55
"151","CA","",0,1,0,0,0,1
"152","CA","AVALANCHE",9,10,140000,0,140000,19
"153","CA","BLIZZARD",0,0,150000,0,150000,0
"154","CA","DAM BREAK",0,0,0,0,0,0
"155","CA","DOWNBURST",0,0,0,0,0,0
"156","CA","DOWNBURST WIND",0,0,0,0,0,0
"157","CA","DROUGHT",0,0,50000,0,50000,0
"158","CA","DRY",0,0,0,0,0,0
"159","CA","DRY MICROBURST",0,1,38000,0,38000,1
"160","CA","DUST",0,0,0,0,0,0
"161","CA","DUST DEVIL",0,15,18100,0,18100,15
"162","CA","DUST STORM",3,95,1735000,1e+05,1835000,98
"163","CA","EROSION",0,0,0,0,0,0
"164","CA","FIRE WX",0,0,0,0,0,0
"165","CA","FLOOD",78,110,2126486000,818436000,2944922000,188
"166","CA","FOG",32,570,13791000,0,13791000,602
"167","CA","FREEZE",0,0,0,115300000,115300000,0
"168","CA","FROST",0,0,0,0,0,0
"169","CA","FROST FREEZE",0,0,705000,154102000,154807000,0
"170","CA","FUNNEL CLOUD",0,2,5000,0,5000,2
"171","CA","GUSTNADO",0,0,0,0,0,0
"172","CA","HAIL",1,20,5344650,176414000,181758650,21
"173","CA","HEAT",118,265,180000,492402000,492582000,383
"174","CA","ICE",0,0,0,0,0,0
"175","CA","ICE STORM",2,0,1e+06,0,1e+06,2
"176","CA","LAND SLIDE",26,15,222853500,2e+07,242853500,41
"177","CA","LIGHTNING",10,56,10281700,750000,11031700,66
"178","CA","MICROBURST",0,0,0,0,0,0
"179","CA","MUD SLIDE",0,0,50000,0,50000,0
"180","CA","OTHER",1,2,50000,0,50000,3
"181","CA","PRECIPITATION",0,0,0,0,0,0
"182","CA","RAIN",22,88,306806500,691381000,998187500,110
"183","CA","RIP CURRENT",46,98,41462000,0,41462000,144
"184","CA","SMOKE",0,0,0,0,0,0
"185","CA","SNOW",28,57,7370000,0,7370000,85
"186","CA","SPELL",0,0,0,0,0,0
"187","CA","STORM",2,32,3926000,0,3926000,34
"188","CA","SURF",52,88,20297000,0,20297000,140
"189","CA","TEMPERATURE_HIGH",0,0,0,0,0,0
"190","CA","TEMPERATURE_LOW",5,13,305000,731160000,731465000,18
"191","CA","THUNDERSTORM",1,0,865000,17205000,18070000,1
"192","CA","THUNDERSTORM WIND",9,42,21300500,59965000,81265500,51
"193","CA","TIDE",4,7,955000,0,955000,11
"194","CA","TORNADO",0,88,114029960,716550,114746510,88
"195","CA","TROPICAL STORM",0,0,0,4500000,4500000,0
"196","CA","WATERSPOUT",0,0,0,0,0,0
"197","CA","WET MICROBURST",0,0,0,0,0,0
"198","CA","WILD FIRE",39,1128,3993787830,140960000,4134747830,1167
"199","CA","WIND",31,269,520263920,89160200,609424120,300
"200","CA","WINTER STORM",26,123,133046000,15500000,148546000,149
"201","CA","WINTER WEATHER",5,83,515000,0,515000,88
"202","CO","AVALANCHE",48,35,491800,0,491800,83
"203","CO","BLIZZARD",10,4,71570000,0,71570000,14
"204","CO","DROUGHT",0,0,0,0,0,0
"205","CO","DRY MICROBURST",1,13,149800,0,149800,14
"206","CO","DUST DEVIL",0,0,20000,0,20000,0
"207","CO","DUST STORM",0,19,80000,0,80000,19
"208","CO","FLOOD",15,64,484332650,5821000,490153650,79
"209","CO","FOG",1,5,350000,0,350000,6
"210","CO","FREEZE",0,0,0,19500000,19500000,0
"211","CO","FREEZE RAIN",0,0,0,0,0,0
"212","CO","FROST FREEZE",0,0,0,9045000,9045000,0
"213","CO","FUNNEL CLOUD",0,0,0,0,0,0
"214","CO","HAIL",0,121,1423944900,116490000,1540434900,121
"215","CO","HEAT",0,0,0,0,0,0
"216","CO","ICE STORM",0,0,0,0,0,0
"217","CO","LAND SLIDE",4,14,2981500,0,2981500,18
"218","CO","LIGHTING",0,0,0,0,0,0
"219","CO","LIGHTNING",48,260,16895600,93400,16989000,308
"220","CO","MICROBURST WIND",0,0,450000,0,450000,0
"221","CO","RAIN",2,2,1030650,10000,1040650,4
"222","CO","SMOKE",0,0,0,0,0,0
"223","CO","SNOW",9,15,740058.5,5e+06,5740058.5,24
"224","CO","TEMPERATURE_LOW",4,15,0,10054000,10054000,19
"225","CO","THUNDERSTORM WIND",10,86,21221800,18090000,39311800,96
"226","CO","TORNADO",5,261,287528940,6514500,294043440,266
"227","CO","WATERSPOUT",0,0,0,0,0,0
"228","CO","WET MICROBURST",0,0,0,0,0,0
"229","CO","WILD FIRE",0,11,305880000,25000,305905000,11
"230","CO","WIND",3,73,49318800,66000,49384800,76
"231","CO","WINTER STORM",2,6,32210500,0,32210500,8
"232","CO","WINTER WEATHER",1,0,44000,0,44000,1
"233","CT","BLIZZARD",0,0,0,0,0,0
"234","CT","DROUGHT",0,0,0,0,0,0
"235","CT","FLOOD",6,3,46730500,0,46730500,9
"236","CT","FREEZE",0,0,0,0,0,0
"237","CT","FREEZE RAIN",0,0,0,0,0,0
"238","CT","FROST FREEZE",0,0,0,0,0,0
"239","CT","FUNNEL CLOUD",0,0,0,0,0,0
"240","CT","HAIL",0,0,292500,30000,322500,0
"241","CT","HEAT",1,0,0,0,0,1
"242","CT","ICE",0,0,0,0,0,0
"243","CT","ICE STORM",2,3,2506000,0,2506000,5
"244","CT","LIGHTNING",4,59,1283000,0,1283000,63
"245","CT","PRECIPITATION",0,0,0,0,0,0
"246","CT","RAIN",2,0,119000,0,119000,2
"247","CT","RIP CURRENT",2,0,0,0,0,2
"248","CT","SMOKE",0,0,0,0,0,0
"249","CT","SNOW",1,0,25260000,0,25260000,1
"250","CT","STORM",2,0,0,0,0,2
"251","CT","TEMPERATURE_HIGH",0,0,0,0,0,0
"252","CT","TEMPERATURE_LOW",0,0,0,0,0,0
"253","CT","THUNDERSTORM WIND",4,64,9406850.5,0,9406850.5,68
"254","CT","TORNADO",4,703,596236620,0,596236620,707
"255","CT","TROPICAL STORM",0,0,60004000,0,60004000,0
"256","CT","WIND",10,18,14029700,0,14029700,28
"257","CT","WINTER STORM",1,0,5510000,0,5510000,1
"258","CT","WINTER WEATHER",2,47,163000,0,163000,49
"259","DC","BLIZZARD",0,2,50000,0,50000,2
"260","DC","DROUGHT",0,0,0,5000,5000,0
"261","DC","DRY",0,0,0,0,0,0
"262","DC","FLOOD",0,2,26250000,0,26250000,2
"263","DC","FOG",0,0,0,0,0,0
"264","DC","FREEZE RAIN",0,0,0,0,0,0
"265","DC","FROST FREEZE",0,0,0,0,0,0
"266","DC","FUNNEL CLOUD",0,0,0,0,0,0
"267","DC","HAIL",0,0,500,0,500,0
"268","DC","HEAT",22,316,0,0,0,338
"269","DC","ICE STORM",0,0,20000,0,20000,0
"270","DC","LIGHTNING",0,12,35000,0,35000,12
"271","DC","RAIN",0,2,3000,0,3000,2
"272","DC","SNOW",0,0,35000,0,35000,0
"273","DC","STORM",0,0,75000,0,75000,0
"274","DC","TEMPERATURE_HIGH",0,1,0,0,0,1
"275","DC","TEMPERATURE_LOW",2,0,0,0,0,2
"276","DC","THUNDERSTORM WIND",3,36,3078500,0,3078500,39
"277","DC","TORNADO",0,0,2000,0,2000,0
"278","DC","TROPICAL STORM",0,0,127600000,0,127600000,0
"279","DC","WEATHER",2,0,0,0,0,2
"280","DC","WIND",1,12,660100,0,660100,13
"281","DC","WINTER STORM",1,0,5000,0,5000,1
"282","DC","WINTER WEATHER",0,0,0,0,0,0
"283","DE","BLIZZARD",0,0,1e+06,0,1e+06,0
"284","DE","DROUGHT",0,0,0,29100000,29100000,0
"285","DE","DRY",0,0,0,0,0,0
"286","DE","DUST STORM",0,0,0,0,0,0
"287","DE","EROSION FLOOD",0,0,2e+06,0,2e+06,0
"288","DE","FLOOD",6,12,71409500,0,71409500,18
"289","DE","FOG",0,0,0,0,0,0
"290","DE","FREEZE RAIN",0,0,0,0,0,0
"291","DE","FROST FREEZE",0,0,0,0,0,0
"292","DE","FUNNEL CLOUD",0,0,0,0,0,0
"293","DE","HAIL",0,0,120050,3e+05,420050,0
"294","DE","HEAT",8,51,0,0,0,59
"295","DE","HURRICANE",0,0,50000,0,50000,0
"296","DE","ICE",0,0,0,0,0,0
"297","DE","ICE STORM",0,0,0,0,0,0
"298","DE","LIGHTNING",1,5,6413500,0,6413500,6
"299","DE","PRECIPITATION",0,0,0,0,0,0
"300","DE","RAIN",0,1,0,0,0,1
"301","DE","RIP CURRENT",4,36,0,0,0,40
"302","DE","SLEET FREEZE RAIN",0,0,0,0,0,0
"303","DE","SLEET RAIN SNOW",0,0,0,0,0,0
"304","DE","SMOKE",0,0,0,0,0,0
"305","DE","SNOW",0,30,0,0,0,30
"306","DE","STORM",0,0,0,0,0,0
"307","DE","SURF",0,66,1e+05,0,1e+05,66
"308","DE","TEMPERATURE_HIGH",1,0,0,0,0,1
"309","DE","TEMPERATURE_LOW",0,0,0,0,0,0
"310","DE","THUNDERSTORM RAIN",0,0,0,0,0,0
"311","DE","THUNDERSTORM WIND",1,10,5648500,201000,5849500,11
"312","DE","TIDE",0,0,1e+06,0,1e+06,0
"313","DE","TORNADO",2,73,12913750,5000,12918750,75
"314","DE","TROPICAL STORM",0,0,17750000,0,17750000,0
"315","DE","WATERSPOUT",0,0,0,0,0,0
"316","DE","WET",0,0,0,0,0,0
"317","DE","WILD FIRE",0,1,5000,0,5000,1
"318","DE","WIND",2,3,17162620,0,17162620,5
"319","DE","WINTER STORM",5,40,13850000,0,13850000,45
"320","DE","WINTER WEATHER",0,10,0,0,0,10
"321","FL","DROUGHT",0,0,0,1e+08,1e+08,0
"322","FL","DUST DEVIL",0,0,25000,0,25000,0
"323","FL","EROSION",0,0,1e+05,0,1e+05,0
"324","FL","FLOOD",10,4,1510714400,972092500,2482806900,14
"325","FL","FOG",6,47,1730000,0,1730000,53
"326","FL","FREEZE",0,0,8200000,68955000,77155000,0
"327","FL","FROST FREEZE",0,0,3020000,483150000,486170000,0
"328","FL","FUNNEL CLOUD",0,0,20500,0,20500,0
"329","FL","HAIL",0,8,31977550,19271000,51248550,8
"330","FL","HEAT",11,11,0,0,0,22
"331","FL","HURRICANE",47,812,2944496000,1448210000,4392706000,859
"332","FL","LIGHTING",0,2,10000,0,10000,2
"333","FL","LIGHTNING",123,858,83919350,81000,84000350,981
"334","FL","RAIN",0,1,21119500,2e+05,21319500,1
"335","FL","RIP CURRENT",271,247,0,0,0,518
"336","FL","SEICHE",0,0,0,0,0,0
"337","FL","SLEET",0,0,0,0,0,0
"338","FL","SMOKE",0,0,0,0,0,0
"339","FL","SNOW",0,0,0,0,0,0
"340","FL","STORM",11,7,224075000,0,224075000,18
"341","FL","SURF",11,11,7622000,0,7622000,22
"342","FL","TEMPERATURE_LOW",2,0,0,361030000,361030000,2
"343","FL","THUNDERSTORM WIND",19,274,149856020,326900,150182920,293
"344","FL","TIDE",0,0,2500000,0,2500000,0
"345","FL","TORNADO",186,3340,1751166590,2653500,1753820090,3526
"346","FL","TROPICAL DEPRESSION",0,0,0,0,0,0
"347","FL","TROPICAL STORM",20,118,721844200,103330000,825174200,138
"348","FL","WATERSPOUT",1,31,3532000,0,3532000,32
"349","FL","WHIRLWIND",0,0,7000,0,7000,0
"350","FL","WILD FIRE",1,105,410639000,0,410639000,106
"351","FL","WIND",27,41,1882458710,343952000,2226410710,68
"352","FL","WINTER STORM",0,1,1195000,0,1195000,1
"353","FL","WINTER WEATHER",0,0,0,0,0,0
"354","GA","BLIZZARD",14,402,55500000,1.05e+08,160500000,416
"355","GA","DROUGHT",0,0,0,717285000,717285000,0
"356","GA","DRY",0,0,0,0,0,0
"357","GA","DRY WEATHER",0,0,0,0,0,0
"358","GA","DUST DEVIL",0,0,0,0,0,0
"359","GA","FLOOD",43,26,701750720,13941550,715692270,69
"360","GA","FOG",0,0,0,0,0,0
"361","GA","FREEZE FOG",0,0,0,0,0,0
"362","GA","FREEZE RAIN",0,0,0,0,0,0
"363","GA","FROST FREEZE",0,0,0,160500000,160500000,0
"364","GA","FUNNEL CLOUD",0,0,0,0,0,0
"365","GA","HAIL",0,2,254326600,430000,254756600,2
"366","GA","HEAT",13,3,0,0,0,16
"367","GA","HURRICANE",0,0,7700000,0,7700000,0
"368","GA","ICE",0,0,0,0,0,0
"369","GA","ICE ROAD",0,0,0,0,0,0
"370","GA","ICE STORM",0,6,55560500,0,55560500,6
"371","GA","LAND SLIDE",0,0,1e+05,0,1e+05,0
"372","GA","LIGHTNING",30,254,91174750,3056000,94230750,284
"373","GA","RAIN",1,9,2638500,3000,2641500,10
"374","GA","RIP CURRENT",1,6,1000,0,1000,7
"375","GA","SLEET",0,0,0,0,0,0
"376","GA","SLEET STORM",0,0,0,0,0,0
"377","GA","SNOW",0,1,5088000,5e+05,5588000,1
"378","GA","SURF",0,0,17500,0,17500,0
"379","GA","TEMPERATURE_HIGH",0,0,0,0,0,0
"380","GA","TEMPERATURE_LOW",1,0,0,0,0,1
"381","GA","THUNDERSTORM WIND",35,364,351715900,51639800,403355700,399
"382","GA","TIDE",0,0,0,0,0,0
"383","GA","TORNADO",180,3926,3261026670,10785500,3271812170,4106
"384","GA","TROPICAL DEPRESSION",0,0,0,0,0,0
"385","GA","TROPICAL STORM",0,0,14771000,2200000,16971000,0
"386","GA","WATERSPOUT",0,0,0,0,0,0
"387","GA","WET",0,0,0,0,0,0
"388","GA","WILD FIRE",0,10,27777270,0,27777270,10
"389","GA","WIND",9,52,95010150,27018000,122028150,61
"390","GA","WINTER STORM",0,0,10980000,0,10980000,0
"391","GA","WINTER WEATHER",0,0,0,0,0,0
"392","GM","HAIL",0,0,0,0,0,0
"393","GM","THUNDERSTORM WIND",1,0,3392100,0,3392100,1
"394","GM","WATERSPOUT",0,0,110200,0,110200,0
"395","GM","WIND",0,0,100740,0,100740,0
"396","GU","DROUGHT",0,0,0,0,0,0
"397","GU","FLOOD",1,1,6892000,575000,7467000,2
"398","GU","FUNNEL CLOUD",0,0,0,0,0,0
"399","GU","HURRICANE",3,334,313860000,104750000,418610000,337
"400","GU","LAND SLIDE",0,0,201000,0,201000,0
"401","GU","LIGHTNING",2,0,467000,0,467000,2
"402","GU","RAIN",19,8,2020000,0,2020000,27
"403","GU","RIP CURRENT",38,55,42000,0,42000,93
"404","GU","STORM",0,0,1150000,850000,2e+06,0
"405","GU","SURF",16,8,0,0,0,24
"406","GU","THUNDERSTORM WIND",0,0,125000,0,125000,0
"407","GU","TROPICAL DEPRESSION",0,0,50000,0,50000,0
"408","GU","TROPICAL STORM",2,0,20760000,241000,21001000,2
"409","GU","TYPHOON",0,5,600230000,825000,601055000,5
"410","GU","VOLCANIC ASH",0,0,0,0,0,0
"411","GU","WATERSPOUT",0,0,0,0,0,0
"412","GU","WILD FIRE",0,1,250000,0,250000,1
"413","GU","WIND",0,4,795000,125000,920000,4
"414","HI","",0,0,0,0,0,0
"415","HI","BLIZZARD",0,0,0,0,0,0
"416","HI","DROUGHT",0,0,0,1e+05,1e+05,0
"417","HI","DUST DEVIL",0,0,0,0,0,0
"418","HI","FLOOD",10,11,162867050,635000,163502050,21
"419","HI","FUNNEL CLOUD",0,0,0,0,0,0
"420","HI","HAIL",0,0,0,0,0,0
"421","HI","HEAT",0,0,0,0,0,0
"422","HI","HURRICANE",0,0,5e+06,0,5e+06,0
"423","HI","ICE STORM",0,0,0,0,0,0
"424","HI","LIGHTNING",0,4,80000,0,80000,4
"425","HI","OTHER",0,0,0,0,0,0
"426","HI","RAIN",2,0,13515000,1500000,15015000,2
"427","HI","RIP CURRENT",0,0,14200000,0,14200000,0
"428","HI","SNOW",0,0,0,0,0,0
"429","HI","STREAM",0,0,0,0,0,0
"430","HI","SURF",28,32,1350500,0,1350500,60
"431","HI","THUNDERSTORM WIND",0,0,179000,770000,949000,0
"432","HI","TORNADO",0,6,3920560,0,3920560,6
"433","HI","WATERSPOUT",0,0,0,0,0,0
"434","HI","WAVE",0,2,0,0,0,2
"435","HI","WILD FIRE",0,12,1240200,2271630,3511830,12
"436","HI","WIND",4,28,9935500,2600000,12535500,32
"437","HI","WINTER STORM",0,0,0,0,0,0
"438","HI","WINTER WEATHER",0,0,0,0,0,0
"439","IA","BLIZZARD",3,7,5170030,0,5170030,10
"440","IA","DROUGHT",0,0,645150000,2009630000,2654780000,0
"441","IA","DUST DEVIL",0,5,0,0,0,5
"442","IA","FLOOD",9,138,1788766500,1627879300,3416645800,147
"443","IA","FOG",0,0,362000,0,362000,0
"444","IA","FREEZE",0,0,0,2e+08,2e+08,0
"445","IA","FREEZE RAIN",1,0,870500,0,870500,1
"446","IA","FROST",0,0,0,9.3e+07,9.3e+07,0
"447","IA","FROST FREEZE",0,0,1e+06,16290000,17290000,0
"448","IA","FUNNEL",0,0,0,0,0,0
"449","IA","FUNNEL CLOUD",0,0,0,0,0,0
"450","IA","GUSTNADO",0,0,102050,1550,103600,0
"451","IA","HAIL",4,134,247169850,294938450,542108300,138
"452","IA","HEAT",5,22,6492200,0,6492200,27
"453","IA","ICE JAM FLOOD",0,0,11000,0,11000,0
"454","IA","ICE STORM",1,2,37424490,0,37424490,3
"455","IA","LIGHTNING",9,40,16057250,10500,16067750,49
"456","IA","RAIN",0,0,1292000,71000,1363000,0
"457","IA","SLEET",0,0,0,0,0,0
"458","IA","SNOW",3,0,43794000,65900000,109694000,3
"459","IA","TEMPERATURE_LOW",4,0,1e+06,20100000,21100000,4
"460","IA","THUNDERSTORM WIND",12,293,326777620,154365150,481142770,305
"461","IA","TORNADO",81,2208,2286576200,5611000,2292187200,2289
"462","IA","WALL CLOUD",0,0,0,0,0,0
"463","IA","WET",0,0,0,2.08e+08,2.08e+08,0
"464","IA","WILD FIRE",0,2,1100000,0,1100000,2
"465","IA","WIND",3,25,73285810,888100,74173910,28
"466","IA","WINTER STORM",5,16,7205000,0,7205000,21
"467","IA","WINTER WEATHER",0,0,371500,0,371500,0
"468","ID","AVALANCHE",16,9,36000,0,36000,25
"469","ID","BLIZZARD",3,1,497000,0,497000,4
"470","ID","DROUGHT",0,0,0,0,0,0
"471","ID","DRY MICROBURST",0,0,62000,0,62000,0
"472","ID","DUST STORM",0,11,5000,0,5000,11
"473","ID","FLOOD",2,2,130019000,25000,130044000,4
"474","ID","FOG",0,3,110000,0,110000,3
"475","ID","FREEZE",0,0,0,1e+05,1e+05,0
"476","ID","FREEZE RAIN",1,0,0,0,0,1
"477","ID","FROST",0,0,0,5e+06,5e+06,0
"478","ID","FROST FREEZE",0,0,0,0,0,0
"479","ID","FUNNEL CLOUD",0,0,2000,0,2000,0
"480","ID","HAIL",0,6,2247500,472000,2719500,6
"481","ID","HEAT",0,0,0,0,0,0
"482","ID","ICE STORM",0,0,0,0,0,0
"483","ID","LAND SLIDE",0,0,605000,0,605000,0
"484","ID","LIGHTNING",7,26,3122500,50000,3172500,33
"485","ID","MUD SLIDE",0,0,100,0,100,0
"486","ID","RAIN",1,0,51355000,5000,51360000,1
"487","ID","SNOW",7,10,12635000,5000,12640000,17
"488","ID","TEMPERATURE_LOW",0,0,50000,0,50000,0
"489","ID","THUNDERSNOW",1,1,50000,0,50000,2
"490","ID","THUNDERSTORM WIND",10,152,13356300,6038000,19394300,162
"491","ID","TIDE",0,0,0,0,0,0
"492","ID","TORNADO",0,9,9497860,10000,9507860,9
"493","ID","WET",0,0,0,5e+06,5e+06,0
"494","ID","WILD FIRE",3,1,11520000,385000,11905000,4
"495","ID","WIND",3,26,14646800,3000,14649800,29
"496","ID","WINTER STORM",3,13,542000,0,542000,16
"497","ID","WINTER WEATHER",1,3,0,0,0,4
"498","IL","BLIZZARD",0,0,1455000,0,1455000,0
"499","IL","DROUGHT",0,0,0,284570000,284570000,0
"500","IL","DUST STORM",0,0,1000,0,1000,0
"501","IL","FLOOD",27,31,1047702010,5070459050,6118161060,58
"502","IL","FOG",0,0,1e+05,0,1e+05,0
"503","IL","FREEZE FOG",0,0,0,0,0,0
"504","IL","FREEZE RAIN",0,0,0,0,0,0
"505","IL","FROST",0,0,0,0,0,0
"506","IL","FROST FREEZE",0,0,0,29380000,29380000,0
"507","IL","FUNNEL CLOUD",0,0,0,0,0,0
"508","IL","HAIL",0,44,100970550,6888600,107859150,44
"509","IL","HEAT",983,594,55000,460000,515000,1577
"510","IL","ICE ICE",0,0,4500,300,4800,0
"511","IL","ICE JAM",0,0,0,0,0,0
"512","IL","ICE STORM",0,2,2105000,0,2105000,2
"513","IL","LAND SLIDE",0,0,50000,0,50000,0
"514","IL","LIGHTNING",20,69,19679300,0,19679300,89
"515","IL","MUD SLIDE",0,0,550000,0,550000,0
"516","IL","RAIN",0,0,1011000,0,1011000,0
"517","IL","RIP CURRENT",1,0,0,0,0,1
"518","IL","SEICHE",0,0,0,0,0,0
"519","IL","SLEET",0,0,0,0,0,0
"520","IL","SLEET STORM",0,0,0,0,0,0
"521","IL","SNOW",7,30,5618500,300,5618800,37
"522","IL","STREAM",0,0,0,0,0,0
"523","IL","TEMPERATURE_HIGH",0,0,0,0,0,0
"524","IL","TEMPERATURE_LOW",15,6,0,0,0,21
"525","IL","THUNDERSTORM WIND",26,555,543755230,143466500,687221730,581
"526","IL","TORNADO",203,4145,1770414550,2298300,1772712850,4348
"527","IL","WATERSPOUT",0,0,0,0,0,0
"528","IL","WAVE",0,0,0,0,0,0
"529","IL","WILD FIRE",0,0,2125000,0,2125000,0
"530","IL","WIND",126,56,27544450,13024000,40568450,182
"531","IL","WINTER STORM",13,31,13711000,0,13711000,44
"532","IL","WINTER WEATHER",0,0,43500,0,43500,0
"533","IN","BLIZZARD",0,0,1e+05,0,1e+05,0
"534","IN","DROUGHT",0,0,0,7.3e+07,7.3e+07,0
"535","IN","DUST DEVIL",0,0,0,0,0,0
"536","IN","DUST STORM",0,1,50000,0,50000,1
"537","IN","FLOOD",43,13,1167822650,790916500,1958739150,56
"538","IN","FOG",1,0,470000,0,470000,1
"539","IN","FREEZE FOG",0,0,0,0,0,0
"540","IN","FREEZE RAIN",0,0,0,0,0,0
"541","IN","FROST",0,0,0,0,0,0
"542","IN","FROST FREEZE",0,0,0,2630000,2630000,0
"543","IN","FUNNEL CLOUD",0,0,0,0,0,0
"544","IN","HAIL",0,0,82729250,3645000,86374250,0
"545","IN","HEAT",16,84,1e+06,0,1e+06,100
"546","IN","ICE",0,0,0,0,0,0
"547","IN","ICE STORM",0,2,1060000,0,1060000,2
"548","IN","LIGHTNING",15,89,28414800,0,28414800,104
"549","IN","RAIN",0,0,163500,1000,164500,0
"550","IN","RIP CURRENT",11,4,0,0,0,15
"551","IN","SLEET ICE STORM",0,0,5e+05,0,5e+05,0
"552","IN","SNOW",1,3,3815000,2e+05,4015000,4
"553","IN","TEMPERATURE_HIGH",0,0,0,0,0,0
"554","IN","TEMPERATURE_LOW",4,0,5160000,0,5160000,4
"555","IN","THUNDERSTORM WIND",32,282,100721250,735500,101456750,314
"556","IN","TORNADO",252,4224,2594793890,516000,2595309890,4476
"557","IN","WATERSPOUT",0,0,0,0,0,0
"558","IN","WILD FIRE",0,0,0,0,0,0
"559","IN","WIND",15,14,26815600,3e+06,29815600,29
"560","IN","WINTER STORM",0,0,2160000,0,2160000,0
"561","IN","WINTER WEATHER",1,4,95000,0,95000,5
"562","KS","BLIZZARD",1,10,6457000,0,6457000,11
"563","KS","DROUGHT",0,0,0,155954000,155954000,0
"564","KS","DRY MICROBURST",0,0,1000,0,1000,0
"565","KS","DUST DEVIL",0,0,0,0,0,0
"566","KS","DUST STORM",0,0,0,0,0,0
"567","KS","FLOOD",24,24,548165350,108131000,656296350,48
"568","KS","FOG",5,25,120000,0,120000,30
"569","KS","FREEZE",0,0,0,0,0,0
"570","KS","FREEZE FOG",0,0,40000,0,40000,0
"571","KS","FROST FREEZE",0,0,15000,4250000,4265000,0
"572","KS","FUNNEL CLOUD",0,0,0,0,0,0
"573","KS","HAIL",0,121,506524900,259405300,765930200,121
"574","KS","HEAT",15,17,108000,0,108000,32
"575","KS","ICE",1,4,60000,0,60000,5
"576","KS","ICE SNOW",0,0,0,0,0,0
"577","KS","ICE STORM",16,25,184665000,0,184665000,41
"578","KS","LIGHTNING",9,40,20799065,29300,20828365,49
"579","KS","OTHER",0,0,0,0,0,0
"580","KS","RAIN",0,7,2339000,554000,2893000,7
"581","KS","SLEET",0,0,0,0,0,0
"582","KS","SNOW",10,18,9431000,50010000,59441000,28
"583","KS","TEMPERATURE_LOW",0,0,2.5e+07,2500000,27500000,0
"584","KS","THUNDERSTORM DAMAGE",0,0,0,0,0,0
"585","KS","THUNDERSTORM WIND",14,352,326975500,43258600,370234100,366
"586","KS","TIDE",0,0,0,0,0,0
"587","KS","TORNADO",236,2721,2669890670,12275000,2682165670,2957
"588","KS","WAKE WIND",0,0,0,0,0,0
"589","KS","WILD FIRE",0,4,2615000,30000,2645000,4
"590","KS","WIND",6,21,10806940,673500,11480440,27
"591","KS","WINTER STORM",16,49,106775000,5e+05,107275000,65
"592","KS","WINTER WEATHER",3,11,3616000,0,3616000,14
"593","KY","BLIZZARD",1,0,0,0,0,1
"594","KY","DROUGHT",0,0,0,2.26e+08,2.26e+08,0
"595","KY","FIRE",0,0,10000,0,10000,0
"596","KY","FLOOD",60,27,790431000,39120500,829551500,87
"597","KY","FOG",0,0,0,0,0,0
"598","KY","FREEZE FOG",0,0,0,0,0,0
"599","KY","FREEZE RAIN",0,0,0,0,0,0
"600","KY","FROST",0,0,0,0,0,0
"601","KY","FROST FREEZE",0,0,0,4485000,4485000,0
"602","KY","FUNNEL CLOUD",0,0,25000,0,25000,0
"603","KY","HAIL",0,8,611568600,5584650,617153250,8
"604","KY","HEAT",6,152,0,0,0,158
"605","KY","ICE",2,0,0,0,0,2
"606","KY","ICE STORM",1,0,65533000,0,65533000,1
"607","KY","LAND SLIDE",0,0,0,0,0,0
"608","KY","LIGHTNING",12,37,7018000,18000,7036000,49
"609","KY","PRECIPITATION",0,0,0,0,0,0
"610","KY","RAIN",0,0,76000,0,76000,0
"611","KY","SLEET",0,0,0,0,0,0
"612","KY","SNOW",8,5,11622450,0,11622450,13
"613","KY","TEMPERATURE",0,0,0,0,0,0
"614","KY","TEMPERATURE_HIGH",0,0,0,0,0,0
"615","KY","TEMPERATURE_LOW",0,0,283000,0,283000,0
"616","KY","THUNDERSTORM WIND",15,402,274429460,2470550,276900010,417
"617","KY","TORNADO",125,2806,888768680,1908000,890676680,2931
"618","KY","WILD FIRE",0,0,25000,0,25000,0
"619","KY","WIND",9,39,87555450,15306000,102861450,48
"620","KY","WINTER STORM",0,0,5738200,0,5738200,0
"621","KY","WINTER WEATHER",0,4,410000,0,410000,4
"622","LA","DROUGHT",0,0,0,587430000,587430000,0
"623","LA","DUST DEVIL",0,0,10000,0,10000,0
"624","LA","FLOOD",14,6,823425950,9712000,833137950,20
"625","LA","FOG",1,76,253000,0,253000,77
"626","LA","FREEZE",1,0,0,5e+07,5e+07,1
"627","LA","FUNNEL CLOUD",0,0,0,0,0,0
"628","LA","HAIL",0,8,172108250,6139000,178247250,8
"629","LA","HEAT",62,3,110000,0,110000,65
"630","LA","HURRICANE",2,3,1183422000,392800000,1576222000,5
"631","LA","ICE FOG",0,0,0,0,0,0
"632","LA","ICE STORM",6,17,203265000,20000,203285000,23
"633","LA","LIGHTNING",25,117,35367550,35000,35402550,142
"634","LA","RAIN",0,0,70000,0,70000,0
"635","LA","RIP CURRENT",2,2,0,0,0,4
"636","LA","SNOW",0,0,3e+05,0,3e+05,0
"637","LA","STORM",0,0,527987000,0,527987000,0
"638","LA","TEMPERATURE_LOW",2,0,7850000,2e+07,27850000,2
"639","LA","THUNDERSTORM",0,0,50000,0,50000,0
"640","LA","THUNDERSTORM WIND",27,278,847519350,1312000,848831350,305
"641","LA","TIDE",0,0,0,0,0,0
"642","LA","TORNADO",153,2637,1179366890,3843000,1183209890,2790
"643","LA","TROPICAL DEPRESSION",0,0,0,0,0,0
"644","LA","TROPICAL STORM",1,12,307019000,154600000,461619000,13
"645","LA","WATERSPOUT",5,39,50021000,0,50021000,44
"646","LA","WILD FIRE",0,3,1276000,2315000,3591000,3
"647","LA","WIND",9,10,4009700,5e+05,4509700,19
"648","LA","WINTER STORM",0,4,55000,0,55000,4
"649","LA","WINTER WEATHER",0,0,20000,0,20000,0
"650","LC","HAIL",0,0,0,0,0,0
"651","LC","THUNDERSTORM WIND",0,0,0,0,0,0
"652","LE","HAIL",0,0,0,0,0,0
"653","LE","THUNDERSTORM WIND",0,0,30000,0,30000,0
"654","LE","WATERSPOUT",0,0,0,0,0,0
"655","LH","HAIL",0,0,0,0,0,0
"656","LH","THUNDERSTORM WIND",0,0,0,0,0,0
"657","LH","WATERSPOUT",0,0,0,0,0,0
"658","LM","HAIL",0,0,0,0,0,0
"659","LM","THUNDERSTORM WIND",2,1,1209500,0,1209500,3
"660","LM","WATERSPOUT",0,0,0,0,0,0
"661","LM","WIND",2,1,1422600,0,1422600,3
"662","LO","HAIL",0,0,0,0,0,0
"663","LO","THUNDERSTORM WIND",0,0,70000,0,70000,0
"664","LO","WATERSPOUT",0,0,0,0,0,0
"665","LS","HAIL",0,0,0,0,0,0
"666","LS","THUNDERSTORM WIND",0,0,4e+05,0,4e+05,0
"667","LS","WATERSPOUT",0,0,0,0,0,0
"668","LS","WIND",1,0,0,0,0,1
"669","MA","BLIZZARD",0,0,115000,0,115000,0
"670","MA","DROUGHT",0,0,0,0,0,0
"671","MA","DRY",0,0,0,0,0,0
"672","MA","DUST DEVIL",0,0,0,0,0,0
"673","MA","FLOOD",2,5,280546000,0,280546000,7
"674","MA","FREEZE",0,0,0,0,0,0
"675","MA","FREEZE RAIN",0,0,0,0,0,0
"676","MA","FROST FREEZE",0,0,0,0,0,0
"677","MA","FUNNEL CLOUD",0,0,0,0,0,0
"678","MA","HAIL",0,2,521950,1e+05,621950,2
"679","MA","HEAT",2,0,0,0,0,2
"680","MA","ICE FLOE",0,0,1e+05,0,1e+05,0
"681","MA","ICE STORM",0,2,45385000,0,45385000,2
"682","MA","LAND SLIDE",0,0,0,0,0,0
"683","MA","LIGHTNING",6,171,22652201,0,22652201,177
"684","MA","RAIN",0,0,50000,0,50000,0
"685","MA","RIP CURRENT",1,0,0,0,0,1
"686","MA","SMOKE",0,0,0,0,0,0
"687","MA","SNOW",2,22,74004000,0,74004000,24
"688","MA","STORM",0,0,1780000,0,1780000,0
"689","MA","SURF",1,2,0,0,0,3
"690","MA","TEMPERATURE_HIGH",0,0,0,0,0,0
"691","MA","TEMPERATURE_LOW",1,3,0,0,0,4
"692","MA","THUNDERSTORM WIND",10,124,35465750,1260000,36725750,134
"693","MA","TORNADO",108,1758,756039120,0,756039120,1866
"694","MA","TROPICAL STORM",0,0,34732000,0,34732000,0
"695","MA","WATERSPOUT",0,0,0,0,0,0
"696","MA","WAVE",0,0,0,0,0,0
"697","MA","WIND",7,27,22214890,2000,22216890,34
"698","MA","WINTER STORM",0,0,4972500,0,4972500,0
"699","MA","WINTER WEATHER",0,5,265000,0,265000,5
"700","MD","BLIZZARD",2,150,710000,0,710000,152
"701","MD","DROUGHT",0,0,0,99725780,99725780,0
"702","MD","DRY",0,0,0,0,0,0
"703","MD","DUST DEVIL",0,1,1000,0,1000,1
"704","MD","FLOOD",13,30,152942000,1385000,154327000,43
"705","MD","FOG",1,38,0,0,0,39
"706","MD","FREEZE",0,0,0,1480000,1480000,0
"707","MD","FREEZE FOG",0,0,0,0,0,0
"708","MD","FREEZE RAIN",0,0,0,0,0,0
"709","MD","FROST FREEZE",0,0,0,0,0,0
"710","MD","FUNNEL CLOUD",0,0,0,0,0,0
"711","MD","HAIL",0,1,1186000,621050,1807050,1
"712","MD","HEAT",100,545,30000,4700000,4730000,645
"713","MD","HURRICANE",0,0,1378000,590000,1968000,0
"714","MD","ICE",0,0,0,0,0,0
"715","MD","ICE STORM",0,0,8862000,20000,8882000,0
"716","MD","LAND SPOUT",0,0,5000,0,5000,0
"717","MD","LIGHTNING",13,73,24740600,6000,24746600,86
"718","MD","RAIN",4,35,5028000,0,5028000,39
"719","MD","RIP CURRENT",1,1,0,0,0,2
"720","MD","SLEET FREEZE RAIN",0,0,0,0,0,0
"721","MD","SMOKE",0,0,0,0,0,0
"722","MD","SNOW",0,0,746000,0,746000,0
"723","MD","STORM",0,0,54175000,5000,54180000,0
"724","MD","TEMPERATURE_HIGH",0,3,0,10000,10000,3
"725","MD","TEMPERATURE_LOW",2,0,0,17500,17500,2
"726","MD","THUNDERSTORM WIND",7,103,31635350,157500,31792850,110
"727","MD","TIDE",0,0,0,0,0,0
"728","MD","TORNADO",7,314,331924500,520000,332444500,321
"729","MD","TROPICAL STORM",1,200,538505000,690000,539195000,201
"730","MD","WATERSPOUT",0,0,5000,0,5000,0
"731","MD","WET",0,0,0,0,0,0
"732","MD","WILD FIRE",0,2,0,0,0,2
"733","MD","WIND",2,23,30955640,505000,31460640,25
"734","MD","WINTER STORM",6,13,7086000,0,7086000,19
"735","MD","WINTER WEATHER",3,5,9000,0,9000,8
"736","ME","BLIZZARD",0,0,0,0,0,0
"737","ME","DAM BREAK",0,0,1e+06,0,1e+06,0
"738","ME","DROUGHT",0,0,0,0,0,0
"739","ME","DRY",0,0,0,0,0,0
"740","ME","DUST DEVIL",1,0,10000,0,10000,1
"741","ME","EROSION",0,0,766000,0,766000,0
"742","ME","FLOOD",4,3,200277700,5000,200282700,7
"743","ME","FOG",0,24,0,0,0,24
"744","ME","FREEZE FOG",0,0,0,0,0,0
"745","ME","FREEZE RAIN",2,0,0,0,0,2
"746","ME","FUNNEL CLOUD",0,0,0,0,0,0
"747","ME","HAIL",0,2,500500,130000,630500,2
"748","ME","HURRICANE",0,4,75000,0,75000,4
"749","ME","ICE STORM",1,0,318230000,0,318230000,1
"750","ME","LAND SLUMP",0,0,570000,0,570000,0
"751","ME","LIGHTNING",6,70,9436800,0,9436800,76
"752","ME","OTHER",0,0,0,0,0,0
"753","ME","PRECIPITATION",0,0,0,0,0,0
"754","ME","RAIN",0,4,505000,5e+05,1005000,4
"755","ME","SLEET",0,0,0,0,0,0
"756","ME","SLEET STORM",0,0,0,0,0,0
"757","ME","SNOW",1,0,7700000,0,7700000,1
"758","ME","STORM",0,1,2973000,0,2973000,1
"759","ME","SURF",1,13,189000,0,189000,14
"760","ME","SURGE",0,0,0,0,0,0
"761","ME","TEMPERATURE_HIGH",0,0,0,0,0,0
"762","ME","TEMPERATURE_LOW",1,0,0,0,0,1
"763","ME","THUNDERSTORM WIND",2,20,882000,0,882000,22
"764","ME","TIDE",0,0,2e+05,0,2e+05,0
"765","ME","TORNADO",1,19,9805500,0,9805500,20
"766","ME","TROPICAL STORM",0,0,0,0,0,0
"767","ME","WATERSPOUT",0,0,0,0,0,0
"768","ME","WIND",4,17,8504000,0,8504000,21
"769","ME","WIND TEMPERATURE_LOW",0,0,0,0,0,0
"770","ME","WINTER STORM",1,0,0,0,0,1
"771","ME","WINTER WEATHER",0,0,0,0,0,0
"772","MH","SURF",0,1,5e+06,0,5e+06,1
"773","MI","BLIZZARD",0,0,324000,0,324000,0
"774","MI","DROUGHT",0,0,0,1.5e+08,1.5e+08,0
"775","MI","DUST DEVIL",0,0,30,0,30,0
"776","MI","DUST DEVIL WATERSPOUT",0,0,500,0,500,0
"777","MI","FLOOD",9,7,340905750,26120000,367025750,16
"778","MI","FOG",1,1,0,0,0,2
"779","MI","FREEZE FOG",0,0,0,0,0,0
"780","MI","FREEZE RAIN",0,0,0,0,0,0
"781","MI","FROST FREEZE",0,0,0,0,0,0
"782","MI","FUNNEL",0,0,0,0,0,0
"783","MI","FUNNEL CLOUD",0,0,0,0,0,0
"784","MI","HAIL",0,8,287678800,20024000,307702800,8
"785","MI","HEAT",23,594,0,0,0,617
"786","MI","ICE",0,0,0,0,0,0
"787","MI","ICE STORM",1,4,190652000,25000,190677000,5
"788","MI","LIGHTING",0,0,5e+06,0,5e+06,0
"789","MI","LIGHTNING",19,164,21834400,0,21834400,183
"790","MI","RAIN",0,0,980000,25000,1005000,0
"791","MI","RIP CURRENT",21,9,0,0,0,30
"792","MI","SEICHE",0,0,20000,0,20000,0
"793","MI","SLEET",0,0,0,0,0,0
"794","MI","SLEET STORM",0,0,0,0,0,0
"795","MI","SNOW",1,7,17115000,0,17115000,8
"796","MI","SURF",1,0,0,0,0,1
"797","MI","TEMPERATURE_HIGH",0,0,0,0,0,0
"798","MI","TEMPERATURE_LOW",16,30,52375000,2100000,54475000,46
"799","MI","THUNDERSTORM",0,0,0,0,0,0
"800","MI","THUNDERSTORM WIND",49,372,381743900,39611000,421354900,421
"801","MI","TORNADO",243,3362,1071765550,1513000,1073278550,3605
"802","MI","WATERSPOUT",0,0,2e+05,0,2e+05,0
"803","MI","WAVE",3,0,0,0,0,3
"804","MI","WET SNOW",0,0,0,0,0,0
"805","MI","WILD FIRE",0,4,7556000,1e+06,8556000,4
"806","MI","WIND",10,22,52770750,10002000,62772750,32
"807","MI","WINTER STORM",1,2,4040000,0,4040000,3
"808","MI","WINTER WEATHER",0,0,100500,0,100500,0
"809","MN","BLIZZARD",6,14,25735000,0,25735000,20
"810","MN","DROUGHT",0,0,0,0,0,0
"811","MN","FLOOD",18,40,1557371000,115994300,1673365300,58
"812","MN","FOG",0,0,20000,0,20000,0
"813","MN","FREEZE RAIN",0,0,2e+05,0,2e+05,0
"814","MN","FROST FREEZE",0,0,0,0,0,0
"815","MN","FUNNEL CLOUD",0,0,0,0,0,0
"816","MN","HAIL",0,30,923515700,140700800,1064216500,30
"817","MN","HEAT",15,0,2127500,0,2127500,15
"818","MN","ICE",0,0,50000,0,50000,0
"819","MN","ICE SNOW",0,0,0,0,0,0
"820","MN","ICE STORM",0,1,36457020,0,36457020,1
"821","MN","LIGHTNING",10,70,13694900,65000,13759900,80
"822","MN","MUD SLIDE",0,0,0,0,0,0
"823","MN","RAIN",0,0,45000,15000,60000,0
"824","MN","RIP CURRENT",0,2,0,0,0,2
"825","MN","SNOW",0,0,118000,0,118000,0
"826","MN","TEMPERATURE_LOW",1,0,0,0,0,1
"827","MN","THUNDERSTORM WIND",6,123,875191750,54899150,930090900,129
"828","MN","TORNADO",99,1976,1903701140,13196050,1916897190,2075
"829","MN","WATERSPOUT",0,0,0,0,0,0
"830","MN","WILD FIRE",0,2,4027500,3000,4030500,2
"831","MN","WIND",10,17,11142050,150000,11292050,27
"832","MN","WINTER STORM",2,1,23077000,0,23077000,3
"833","MN","WINTER WEATHER",1,6,49000,0,49000,7
"834","MO","BLIZZARD",0,0,0,0,0,0
"835","MO","DROUGHT",0,0,1e+05,30835000,30935000,0
"836","MO","DUST DEVIL",0,0,0,0,0,0
"837","MO","FLOOD",89,41,847878840,664863300,1512742140,130
"838","MO","FOG",0,0,0,0,0,0
"839","MO","FREEZE",0,0,0,0,0,0
"840","MO","FREEZE FOG",0,0,0,0,0,0
"841","MO","FREEZE RAIN",0,0,0,0,0,0
"842","MO","FROST",0,0,0,0,0,0
"843","MO","FROST FREEZE",0,0,0,5986000,5986000,0
"844","MO","FUNNEL",0,0,0,0,0,0
"845","MO","FUNNEL CLOUD",0,0,0,0,0,0
"846","MO","HAIL",0,6,1136027370,9378300,1145405670,6
"847","MO","HEAT",233,4185,469000,875000,1344000,4418
"848","MO","ICE",0,0,50000,0,50000,0
"849","MO","ICE ICE",0,0,3e+05,500,300500,0
"850","MO","ICE ICE STORM",0,15,0,0,0,15
"851","MO","ICE JAM",0,0,0,0,0,0
"852","MO","ICE STORM",0,0,77132000,3500,77135500,0
"853","MO","LIGHTNING",21,62,7117500,2000,7119500,83
"854","MO","RAIN",2,0,7311010,1e+06,8311010,2
"855","MO","SLEET",0,0,0,0,0,0
"856","MO","SNOW",0,2,21032020,700,21032720,2
"857","MO","TEMPERATURE_HIGH",0,0,0,0,0,0
"858","MO","TEMPERATURE_LOW",4,21,5125000,105000,5230000,25
"859","MO","THUNDERSTORM",0,0,0,0,0,0
"860","MO","THUNDERSTORM WIND",14,320,238647042,7270450,245917492,334
"861","MO","TORNADO",388,4330,2000701720,22266000,2022967720,4718
"862","MO","TROPICAL STORM",0,2,150000,0,150000,2
"863","MO","WAVE",0,0,0,0,0,0
"864","MO","WILD FIRE",0,5,2112000,0,2112000,5
"865","MO","WIND",1,9,23108900,10009000,33117900,10
"866","MO","WINTER STORM",2,0,11961020,0,11961020,2
"867","MO","WINTER WEATHER",0,0,9000,0,9000,0
"868","MS","DROUGHT",0,0,50000,3100000,3150000,0
"869","MS","FLOOD",16,9,468035100,12857000,480892100,25
"870","MS","FOG",0,0,0,0,0,0
"871","MS","FROST FREEZE",0,0,0,0,0,0
"872","MS","FUNNEL",0,0,0,0,0,0
"873","MS","FUNNEL CLOUD",0,0,100,0,100,0
"874","MS","HAIL",0,18,89366890,10746000,100112890,18
"875","MS","HEAT",26,5,0,76500,76500,31
"876","MS","HURRICANE",16,105,948100010,1514980800,2463080810,121
"877","MS","ICE STORM",0,0,24529000,5000060000,5024589000,0
"878","MS","LIGHTNING",16,39,13599060,9000,13608060,55
"879","MS","RAIN",0,1,220000,0,220000,1
"880","MS","SLEET",0,0,0,0,0,0
"881","MS","SNOW",0,0,4713700,0,4713700,0
"882","MS","STORM",0,0,6790000,0,6790000,0
"883","MS","STREAM",0,0,0,0,0,0
"884","MS","TEMPERATURE_LOW",4,0,1e+05,0,1e+05,4
"885","MS","THUNDERSTORM WIND",21,246,258098850,13508300,271607150,267
"886","MS","TORNADO",450,6246,2442465030,54135000,2496600030,6696
"887","MS","TROPICAL DEPRESSION",0,0,45000,0,45000,0
"888","MS","TROPICAL STORM",1,0,50316000,0,50316000,1
"889","MS","WATERSPOUT",0,0,502500,0,502500,0
"890","MS","WILD FIRE",0,0,0,0,0,0
"891","MS","WIND",5,6,12364910,335000,12699910,11
"892","MS","WINTER STORM",0,0,596000,0,596000,0
"893","MS","WINTER WEATHER",0,0,240000,0,240000,0
"894","MT","AVALANCHE",9,4,0,0,0,13
"895","MT","BLIZZARD",3,7,2450000,0,2450000,10
"896","MT","DROUGHT",0,0,0,990000,990000,0
"897","MT","DRY MICROBURST",0,0,52000,0,52000,0
"898","MT","DUST DEVIL",0,3,44000,0,44000,3
"899","MT","DUST STORM",1,8,50000,5e+05,550000,9
"900","MT","FIRE",0,0,5e+06,5e+05,5500000,0
"901","MT","FLOOD",7,0,54385000,1795000,56180000,7
"902","MT","FOG",0,0,0,0,0,0
"903","MT","FREEZE",0,0,0,0,0,0
"904","MT","FREEZE FOG",0,0,142000,0,142000,0
"905","MT","FREEZE RAIN",0,0,250000,0,250000,0
"906","MT","FROST FREEZE",0,0,5e+05,0,5e+05,0
"907","MT","FUNNEL CLOUD",0,0,0,0,0,0
"908","MT","HAIL",0,7,94729700,34345000,129074700,7
"909","MT","HEAT",0,0,0,0,0,0
"910","MT","ICE JAM",0,0,5000,0,5000,0
"911","MT","ICE JAM FLOOD",0,0,5e+06,5e+06,1e+07,0
"912","MT","ICE STORM",2,0,5e+05,0,5e+05,2
"913","MT","LAND SLIDE",0,2,0,0,0,2
"914","MT","LIGHTNING",9,30,1644000,3000,1647000,39
"915","MT","MICROBURST",0,0,5000,0,5000,0
"916","MT","MUD SLIDE FLOOD",0,0,5000,0,5000,0
"917","MT","RAIN",0,0,3000,0,3000,0
"918","MT","SMOKE",0,0,0,0,0,0
"919","MT","SNOW",1,4,4527000,0,4527000,5
"920","MT","STORM",0,0,0,0,0,0
"921","MT","STREAM",0,0,0,0,0,0
"922","MT","TEMPERATURE_LOW",1,0,1400,0,1400,1
"923","MT","THUNDERSTORM WIND",7,30,36297100,14274000,50571100,37
"924","MT","TORNADO",4,21,86600150,130000,86730150,25
"925","MT","WATERSPOUT",0,0,0,0,0,0
"926","MT","WILD FIRE",0,33,27155500,1e+06,28155500,33
"927","MT","WIND",7,21,6637000,657000,7294000,28
"928","MT","WINTER STORM",3,1,20093000,0,20093000,4
"929","MT","WINTER WEATHER",4,10,0,0,0,14
"930","NC","BLIZZARD",0,0,0,0,0,0
"931","NC","DAM BREAK",0,0,2000,0,2000,0
"932","NC","DROUGHT",0,0,0,13067000,13067000,0
"933","NC","DRY WEATHER",0,0,0,0,0,0
"934","NC","DUST DEVIL",0,0,25300,0,25300,0
"935","NC","FLOOD",66,29,379996526,274506900,654503426,95
"936","NC","FOG",1,16,48500,0,48500,17
"937","NC","FREEZE FOG",0,0,0,0,0,0
"938","NC","FREEZE RAIN",0,0,20000,0,20000,0
"939","NC","FROST FREEZE",0,0,0,2012000,2012000,0
"940","NC","FUNNEL CLOUD",0,0,0,0,0,0
"941","NC","HAIL",0,1,39168750,37266000,76434750,1
"942","NC","HEAT",15,17,0,0,0,32
"943","NC","HURRICANE",32,25,2569621000,1456730000,4026351000,57
"944","NC","ICE",0,0,0,0,0,0
"945","NC","ICE PELLET",0,0,0,0,0,0
"946","NC","ICE ROAD",0,0,0,0,0,0
"947","NC","ICE STORM",1,0,279117800,0,279117800,1
"948","NC","LAND SLIDE",4,11,30736000,0,30736000,15
"949","NC","LIGHTNING",29,278,48380000,2070000,50450000,307
"950","NC","MUD SLIDE",0,0,0,0,0,0
"951","NC","OTHER",0,0,0,0,0,0
"952","NC","RAIN",0,7,9428000,0,9428000,7
"953","NC","RIP CURRENT",38,14,0,0,0,52
"954","NC","ROCK SLIDE",0,0,0,0,0,0
"955","NC","SLEET STORM",0,0,0,0,0,0
"956","NC","SMOKE",0,0,0,0,0,0
"957","NC","SNOW",3,2,4042800,0,4042800,5
"958","NC","STORM",0,0,41360000,0,41360000,0
"959","NC","SURF",2,0,0,0,0,2
"960","NC","SURGE",0,0,5e+05,0,5e+05,0
"961","NC","TEMPERATURE_LOW",25,1,775000,754000,1529000,26
"962","NC","THUNDERSTORM",0,2,855000,1e+06,1855000,2
"963","NC","THUNDERSTORM DAMAGE TO",0,0,2000,0,2000,0
"964","NC","THUNDERSTORM WIND",20,223,64805755,3759500,68565255,243
"965","NC","TIDE",0,0,0,0,0,0
"966","NC","TORNADO",126,2548,1551933680,4437000,1556370680,2674
"967","NC","TROPICAL DEPRESSION",0,0,30000,0,30000,0
"968","NC","TROPICAL STORM",0,1,37722100,103135000,140857100,1
"969","NC","WATERSPOUT",0,1,150000,0,150000,1
"970","NC","WILD FIRE",0,0,2605000,0,2605000,0
"971","NC","WIND",21,45,94787230,155225000,250012230,66
"972","NC","WINTER STORM",13,191,73412000,0,73412000,204
"973","NC","WINTER WEATHER",2,3,71000,0,71000,5
"974","ND","BLIZZARD",9,97,224558000,0,224558000,106
"975","ND","DAM FAILURE",0,0,0,0,0,0
"976","ND","DROUGHT",0,0,0,0,0,0
"977","ND","DUST DEVIL",0,1,0,0,0,1
"978","ND","FLOOD",7,5,1071822500,87262000,1159084500,12
"979","ND","FREEZE RAIN",2,13,35000,0,35000,15
"980","ND","FREEZE SPRAY",1,0,0,0,0,1
"981","ND","FROST",1,3,15000,0,15000,4
"982","ND","FROST FREEZE",0,0,0,0,0,0
"983","ND","FUNNEL",0,0,0,0,0,0
"984","ND","FUNNEL CLOUD",0,0,0,0,0,0
"985","ND","HAIL",0,27,472663600,189355000,662018600,27
"986","ND","HEAT",0,0,0,0,0,0
"987","ND","ICE STORM",0,0,98025000,0,98025000,0
"988","ND","LIGHTNING",1,8,2579500,10000,2589500,9
"989","ND","RAIN",1,0,5520000,55020000,60540000,1
"990","ND","SNOW",3,14,740000,0,740000,17
"991","ND","TEMPERATURE_LOW",3,0,0,75000,75000,3
"992","ND","THUNDERSTORM WIND",3,63,240284800,196163000,436447800,66
"993","ND","TORNADO",25,326,172766270,11735000,184501270,351
"994","ND","WILD FIRE",0,6,6e+05,0,6e+05,6
"995","ND","WIND",8,26,8004000,10110000,18114000,34
"996","ND","WINTER STORM",5,19,17957000,0,17957000,24
"997","ND","WINTER WEATHER",0,0,595000,0,595000,0
"998","NE","BLIZZARD",1,5,16508000,50000,16558000,6
"999","NE","DROUGHT",0,0,55000,7.2e+08,720055000,0
"1000","NE","DRY MICROBURST",0,0,340000,0,340000,0
"1001","NE","DUST STORM",2,17,65000,0,65000,19
"1002","NE","FLOOD",6,4,150815608.8,113190000,264005608.8,10
"1003","NE","FOG",0,2,485000,0,485000,2
"1004","NE","FREEZE",0,0,0,312200000,312200000,0
"1005","NE","FREEZE RAIN",0,0,5000,0,5000,0
"1006","NE","FROST FREEZE",0,0,0,50000,50000,0
"1007","NE","FUNNEL CLOUD",0,0,0,0,0,0
"1008","NE","HAIL",0,93,920903050,738083650,1658986700,93
"1009","NE","HEAT",7,0,8092000,150000,8242000,7
"1010","NE","ICE ROAD",2,15,181200,0,181200,17
"1011","NE","ICE STORM",4,5,18027000,0,18027000,9
"1012","NE","LIGHTNING",6,22,12357400,292600,12650000,28
"1013","NE","RAIN",0,0,2719000,11028000,13747000,0
"1014","NE","SNOW",0,0,57005000,4600000,61605000,0
"1015","NE","TEMPERATURE_LOW",0,1,850000,40000,890000,1
"1016","NE","THUNDERSTORM WIND",2,100,156311400,232274000,388585400,102
"1017","NE","TORNADO",54,1158,1718164710,27545750,1745710460,1212
"1018","NE","WET MICROBURST",0,0,20000,0,20000,0
"1019","NE","WILD FIRE",0,0,2692000,5e+06,7692000,0
"1020","NE","WIND",7,27,5953520,1707000,7660520,34
"1021","NE","WINTER STORM",11,22,52094000,4720000,56814000,33
"1022","NE","WINTER WEATHER",0,0,416000,0,416000,0
"1023","NH","AVALANCHE",3,1,0,0,0,4
"1024","NH","BLIZZARD",0,0,0,0,0,0
"1025","NH","DOWNBURST WIND",0,0,0,0,0,0
"1026","NH","DROUGHT",0,0,0,0,0,0
"1027","NH","DRY",0,0,0,0,0,0
"1028","NH","DUST DEVIL",0,0,0,0,0,0
"1029","NH","FLOOD",7,5,105317770,2e+05,105517770,12
"1030","NH","FREEZE FOG",0,0,0,0,0,0
"1031","NH","FREEZE RAIN",0,0,0,0,0,0
"1032","NH","FROST FREEZE",0,0,0,0,0,0
"1033","NH","FUNNEL CLOUD",0,0,0,0,0,0
"1034","NH","HAIL",0,0,9000,0,9000,0
"1035","NH","HEAT",0,0,0,0,0,0
"1036","NH","HURRICANE",0,0,0,0,0,0
"1037","NH","ICE STORM",0,1,64934000,0,64934000,1
"1038","NH","LAND SLUMP",0,0,0,0,0,0
"1039","NH","LIGHTNING",1,85,11276500,0,11276500,86
"1040","NH","MUD SLIDE",0,0,0,0,0,0
"1041","NH","OTHER",0,0,0,0,0,0
"1042","NH","PRECIPITATION",0,0,0,0,0,0
"1043","NH","RAIN",0,0,6e+05,0,6e+05,0
"1044","NH","SNOW",1,17,7833000,0,7833000,18
"1045","NH","STORM",0,0,590000,0,590000,0
"1046","NH","SURF",0,0,20000,0,20000,0
"1047","NH","TEMPERATURE_HIGH",0,0,0,0,0,0
"1048","NH","TEMPERATURE_LOW",4,1,0,0,0,5
"1049","NH","THUNDERSTORM WIND",8,33,12176500,0,12176500,41
"1050","NH","TORNADO",1,30,10609000,0,10609000,31
"1051","NH","TROPICAL STORM",1,1,25000,0,25000,2
"1052","NH","WATERSPOUT",0,0,0,0,0,0
"1053","NH","WET SNOW",0,0,0,0,0,0
"1054","NH","WIND",6,21,6609000,0,6609000,27
"1055","NH","WIND TEMPERATURE_LOW",0,0,0,0,0,0
"1056","NH","WINTER STORM",0,0,189000,0,189000,0
"1057","NH","WINTER WEATHER",0,0,30000,0,30000,0
"1058","NJ","BLIZZARD",3,0,18800000,0,18800000,3
"1059","NJ","DROUGHT",0,0,0,8e+07,8e+07,0
"1060","NJ","DRY",0,0,0,0,0,0
"1061","NJ","DUST DEVIL",0,0,0,0,0,0
"1062","NJ","EROSION FLOOD",0,0,14200000,0,14200000,0
"1063","NJ","FLOOD",25,198,2890090000,750000,2890840000,223
"1064","NJ","FOG",0,17,0,0,0,17
"1065","NJ","FREEZE RAIN",0,0,0,0,0,0
"1066","NJ","FROST FREEZE",0,0,0,0,0,0
"1067","NJ","FUNNEL CLOUD",0,0,0,0,0,0
"1068","NJ","HAIL",0,0,446000,17112000,17558000,0
"1069","NJ","HEAT",48,304,0,0,0,352
"1070","NJ","HURRICANE",0,0,1150000,0,1150000,0
"1071","NJ","ICE",0,0,0,0,0,0
"1072","NJ","ICE STORM",0,0,1e+06,0,1e+06,0
"1073","NJ","LIGHTNING",15,156,15758150,3000,15761150,171
"1074","NJ","MICROBURST",0,0,50000,0,50000,0
"1075","NJ","MUD SLIDE",0,0,0,0,0,0
"1076","NJ","PRECIPITATION",0,0,0,0,0,0
"1077","NJ","RAIN",4,4,3760000,0,3760000,8
"1078","NJ","RIP CURRENT",25,29,0,0,0,54
"1079","NJ","SMOKE",0,0,0,0,0,0
"1080","NJ","SNOW",1,12,19100000,0,19100000,13
"1081","NJ","STORM",0,0,0,0,0,0
"1082","NJ","SURF",5,6,4e+06,0,4e+06,11
"1083","NJ","TEMPERATURE_HIGH",10,0,0,0,0,10
"1084","NJ","TEMPERATURE_LOW",0,0,0,0,0,0
"1085","NJ","THUNDERSTORM",0,1,0,0,0,1
"1086","NJ","THUNDERSTORM RAIN",0,0,0,0,0,0
"1087","NJ","THUNDERSTORM WIND",16,239,49418750,1200000,50618750,255
"1088","NJ","TIDE",0,0,5e+06,0,5e+06,0
"1089","NJ","TORNADO",1,70,79214250,2e+05,79414250,71
"1090","NJ","TROPICAL STORM",1,2,17600000,0,17600000,3
"1091","NJ","WATERSPOUT",0,0,0,0,0,0
"1092","NJ","WET",0,0,0,0,0,0
"1093","NJ","WILD FIRE",0,10,1260000,0,1260000,10
"1094","NJ","WIND",22,69,44274050,0,44274050,91
"1095","NJ","WINTER STORM",2,27,30825000,0,30825000,29
"1096","NJ","WINTER WEATHER",2,8,0,0,0,10
"1097","NM","",0,0,5000,0,5000,0
"1098","NM","BLIZZARD",0,0,0,0,0,0
"1099","NM","DROUGHT",0,0,2e+06,14400000,16400000,0
"1100","NM","DRY MICROBURST",0,0,179500,0,179500,0
"1101","NM","DUST DEVIL",0,1,40500,0,40500,1
"1102","NM","DUST STORM",0,8,45000,0,45000,8
"1103","NM","FLOOD",18,18,81037500,5381000,86418500,36
"1104","NM","FOG",1,1,5000,0,5000,2
"1105","NM","FREEZE RAIN",0,0,0,0,0,0
"1106","NM","FROST",0,0,0,0,0,0
"1107","NM","FUNNEL CLOUD",0,0,0,0,0,0
"1108","NM","HAIL",2,40,124469850,7073600,131543450,42
"1109","NM","HEAT",1,0,0,0,0,1
"1110","NM","HYPERTHERMIA EXPOSURE",1,0,0,0,0,1
"1111","NM","HYPOTHERMIA EXPOSURE",7,0,0,0,0,7
"1112","NM","ICE STORM",0,0,1e+05,0,1e+05,0
"1113","NM","LAND SLIDE",0,0,0,0,0,0
"1114","NM","LIGHTING",0,0,0,0,0,0
"1115","NM","LIGHTNING",12,52,711500,0,711500,64
"1116","NM","OTHER",0,4,5000,0,5000,4
"1117","NM","RAIN",1,7,1476000,0,1476000,8
"1118","NM","SLEET",0,0,0,0,0,0
"1119","NM","SNOW",4,11,180000,0,180000,15
"1120","NM","TEMPERATURE",0,0,0,0,0,0
"1121","NM","TEMPERATURE_LOW",0,0,0,0,0,0
"1122","NM","THUNDERSTORM WIND",3,32,12107200,287000,12394200,35
"1123","NM","TORNADO",5,155,60235180,260000,60495180,160
"1124","NM","WILD FIRE",0,20,148582000,15000,148597000,20
"1125","NM","WIND",12,36,12275550,1000,12276550,48
"1126","NM","WINTER STORM",5,0,4450000,5270000,9720000,5
"1127","NM","WINTER WEATHER",0,0,0,0,0,0
"1128","NV","AVALANCHE",1,2,0,0,0,3
"1129","NV","BLIZZARD",0,0,0,0,0,0
"1130","NV","DRY MICROBURST",0,0,0,0,0,0
"1131","NV","DUST DEVIL",0,0,266500,0,266500,0
"1132","NV","DUST STORM",0,49,250000,0,250000,49
"1133","NV","FLOOD",6,64,737781100,6020000,743801100,70
"1134","NV","FOG",0,0,10000,0,10000,0
"1135","NV","FREEZE FOG",0,0,0,0,0,0
"1136","NV","FROST FREEZE",0,0,3500000,0,3500000,0
"1137","NV","FUNNEL CLOUD",0,0,0,0,0,0
"1138","NV","HAIL",2,3,225550,1e+05,325550,5
"1139","NV","HEAT",67,0,0,0,0,67
"1140","NV","HURRICANE",0,0,0,0,0,0
"1141","NV","ICE ON ROAD",1,0,0,0,0,1
"1142","NV","ICE STORM",3,2,5000,0,5000,5
"1143","NV","LAND SLIDE",0,0,21000,0,21000,0
"1144","NV","LIGHTNING",2,20,4099000,0,4099000,22
"1145","NV","OTHER",0,0,500,0,500,0
"1146","NV","RAIN",0,0,11355000,0,11355000,0
"1147","NV","SNOW",6,13,3990000,20000,4010000,19
"1148","NV","TEMPERATURE_LOW",0,0,50000,0,50000,0
"1149","NV","THUNDERSTORM WIND",4,16,54111200,0,54111200,20
"1150","NV","TORNADO",0,2,1637810,7000,1644810,2
"1151","NV","WATERSPOUT",0,0,0,0,0,0
"1152","NV","WHIRLWIND",1,0,5000,0,5000,1
"1153","NV","WILD FIRE",0,0,10000,0,10000,0
"1154","NV","WIND",8,45,16444400,100050,16544450,53
"1155","NV","WINTER STORM",4,16,610000,0,610000,20
"1156","NV","WINTER WEATHER",0,0,150000,0,150000,0
"1157","NY","",0,0,0,0,0,0
"1158","NY","AVALANCHE",1,5,0,0,0,6
"1159","NY","BLIZZARD",7,4,62500000,0,62500000,11
"1160","NY","DROUGHT",0,0,0,100200000,100200000,0
"1161","NY","DRY SPELL",0,0,0,0,0,0
"1162","NY","DUST DEVIL",0,6,1200,0,1200,6
"1163","NY","EROSION",0,0,0,0,0,0
"1164","NY","FIRE",0,2,0,0,0,2
"1165","NY","FLOOD",60,39,3207840490,6675000,3214515490,99
"1166","NY","FOG",2,14,0,0,0,16
"1167","NY","FREEZE",0,0,0,0,0,0
"1168","NY","FREEZE RAIN",0,0,5486000,0,5486000,0
"1169","NY","FROST",0,0,0,5e+06,5e+06,0
"1170","NY","FROST FREEZE",0,0,1e+05,138000,238000,0
"1171","NY","FUNNEL CLOUD",0,0,0,0,0,0
"1172","NY","HAIL",0,89,10031250,87375600,97406850,89
"1173","NY","HEAT",100,51,0,0,0,151
"1174","NY","ICE",1,24,6e+06,0,6e+06,25
"1175","NY","ICE ROAD",1,7,0,0,0,8
"1176","NY","ICE STORM",2,0,88797000,8550000,97347000,2
"1177","NY","LACK OF SNOW",0,0,0,0,0,0
"1178","NY","LAND SLIDE",0,0,501000,0,501000,0
"1179","NY","LIGHTNING",14,244,13241000,11000,13252000,258
"1180","NY","MIX",0,0,205000,0,205000,0
"1181","NY","MUD SLIDE",0,0,1175000,0,1175000,0
"1182","NY","PRECIPITATION",2,26,259000,0,259000,28
"1183","NY","RAIN",0,7,74000,0,74000,7
"1184","NY","RIP CURRENT",27,6,0,0,0,33
"1185","NY","SEICHE",0,0,210000,0,210000,0
"1186","NY","SMOKE",0,0,0,0,0,0
"1187","NY","SNOW",7,19,185694000,1e+05,185794000,26
"1188","NY","STORM",2,1,16000,0,16000,3
"1189","NY","SURF",5,0,39200000,0,39200000,5
"1190","NY","TEMPERATURE",0,0,0,0,0,0
"1191","NY","TEMPERATURE_HIGH",0,0,0,0,0,0
"1192","NY","TEMPERATURE_LOW",2,0,5613000,0,5613000,2
"1193","NY","THUNDERSTORM WIND",36,344,455477650,11669000,467146650,380
"1194","NY","TIDE",6,0,0,0,0,6
"1195","NY","TORNADO",22,315,466573840,820000,467393840,337
"1196","NY","TROPICAL STORM",1,1,4000,0,4000,2
"1197","NY","WALL CLOUD",0,0,0,0,0,0
"1198","NY","WATERSPOUT",0,0,1e+06,0,1e+06,0
"1199","NY","WILD FIRE",0,0,102000,0,102000,0
"1200","NY","WIND",42,125,178147820,725000,178872820,167
"1201","NY","WINTER SNOW",0,0,0,0,0,0
"1202","NY","WINTER STORM",1,0,20354300,0,20354300,1
"1203","NY","WINTER WEATHER",1,11,1964000,0,1964000,12
"1204","OH","BLIZZARD",1,8,5800000,0,5800000,9
"1205","OH","DOWNBURST",0,0,2000,0,2000,0
"1206","OH","DROUGHT",0,0,0,2e+08,2e+08,0
"1207","OH","DUST DEVIL",0,0,0,0,0,0
"1208","OH","FLOOD",54,33,1717479300,132108000,1849587300,87
"1209","OH","FOG",5,33,562000,0,562000,38
"1210","OH","FREEZE RAIN",0,2,25000,0,25000,2
"1211","OH","FROST",0,0,0,0,0,0
"1212","OH","FROST FREEZE",0,0,0,540000,540000,0
"1213","OH","FUNNEL",0,0,0,0,0,0
"1214","OH","FUNNEL CLOUD",0,0,0,0,0,0
"1215","OH","HAIL",0,13,713502300,17892000,731394300,13
"1216","OH","HEAT",31,112,1100000,5e+06,6100000,143
"1217","OH","ICE",0,166,150000,0,150000,166
"1218","OH","ICE SNOW",0,0,5e+06,0,5e+06,0
"1219","OH","ICE STORM",2,1652,201891000,6e+06,207891000,1654
"1220","OH","LAND SLIDE",0,0,2000,0,2000,0
"1221","OH","LIGHTING",0,0,30000,0,30000,0
"1222","OH","LIGHTNING",32,163,21261000,4605000,25866000,195
"1223","OH","OTHER",0,0,0,1034400,1034400,0
"1224","OH","PRECIPITATION",0,0,0,0,0,0
"1225","OH","RAIN",1,0,564000,0,564000,1
"1226","OH","SEICHE",0,0,0,0,0,0
"1227","OH","SLEET",0,0,0,0,0,0
"1228","OH","SNOW",3,32,73219000,0,73219000,35
"1229","OH","STORM",0,0,6e+06,0,6e+06,0
"1230","OH","TEMPERATURE",0,0,0,0,0,0
"1231","OH","TEMPERATURE_HIGH",0,0,0,0,0,0
"1232","OH","TEMPERATURE_LOW",15,1,5793000,4250000,10043000,16
"1233","OH","THUNDERSTORM",0,0,5000,0,5000,0
"1234","OH","THUNDERSTORM HAIL",0,0,5000,50000,55000,0
"1235","OH","THUNDERSTORM WIND",46,315,231671200,10014000,241685200,361
"1236","OH","TORNADO",191,4442,2283157790,5383500,2288541290,4633
"1237","OH","WATER",1,0,0,0,0,1
"1238","OH","WATERSPOUT",0,0,10000,0,10000,0
"1239","OH","WIND",18,84,660499000,7335000,667834000,102
"1240","OH","WINTER STORM",3,56,927810000,0,927810000,59
"1241","OH","WINTER WEATHER",0,0,550000,0,550000,0
"1242","OK","BLIZZARD",1,0,9580000,7e+06,16580000,1
"1243","OK","DROUGHT",0,4,32669000,1097040000,1129709000,4
"1244","OK","DUST",0,0,20000,0,20000,0
"1245","OK","DUST DEVIL",0,0,24500,0,24500,0
"1246","OK","DUST STORM",0,0,0,0,0,0
"1247","OK","FLOOD",38,175,213143900,50300000,263443900,213
"1248","OK","FOG",0,0,60000,0,60000,0
"1249","OK","FREEZE RAIN",0,0,0,0,0,0
"1250","OK","FUNNEL CLOUD",0,0,0,0,0,0
"1251","OK","HAIL",0,30,176971950,1434000,178405950,30
"1252","OK","HEAT",87,219,10000,0,10000,306
"1253","OK","ICE",0,0,0,0,0,0
"1254","OK","ICE SNOW",0,0,0,0,0,0
"1255","OK","ICE STORM",0,0,688090000,0,688090000,0
"1256","OK","LIGHTNING",13,87,34846450,1000,34847450,100
"1257","OK","OTHER",0,0,0,0,0,0
"1258","OK","RAIN",0,1,1515000,387000,1902000,1
"1259","OK","SNOW",1,0,7452500,0,7452500,1
"1260","OK","STORM",0,0,0,0,0,0
"1261","OK","TEMPERATURE_HIGH",0,0,0,0,0,0
"1262","OK","TEMPERATURE_LOW",5,0,5e+05,0,5e+05,5
"1263","OK","THUNDERSTORM WIND",11,324,1018746950,125000,1018871950,335
"1264","OK","TORNADO",296,4829,3268708230,50556550,3319264780,5125
"1265","OK","TROPICAL STORM",0,0,25000,0,25000,0
"1266","OK","WILD FIRE",5,29,30511000,250000,30761000,34
"1267","OK","WIND",1,5,2107040,0,2107040,6
"1268","OK","WINTER STORM",0,1,27152000,0,27152000,1
"1269","OK","WINTER WEATHER",0,6,460000,0,460000,6
"1270","OR","AVALANCHE",3,5,0,0,0,8
"1271","OR","BLIZZARD",0,0,2e+05,0,2e+05,0
"1272","OR","DROUGHT",0,0,0,22600000,22600000,0
"1273","OR","DRY MICROBURST",0,0,6800,0,6800,0
"1274","OR","DUST DEVIL",0,0,10000,0,10000,0
"1275","OR","DUST STORM",0,8,150000,0,150000,8
"1276","OR","FLOOD",16,13,741862500,18860000,760722500,29
"1277","OR","FOG",1,17,60000,0,60000,18
"1278","OR","FREEZE RAIN",0,0,0,0,0,0
"1279","OR","FROST FREEZE",0,0,0,0,0,0
"1280","OR","FUNNEL CLOUD",0,0,0,0,0,0
"1281","OR","HAIL",0,6,52607700,36028000,88635700,6
"1282","OR","HEAT",1,0,0,0,0,1
"1283","OR","ICE STORM",2,33,1050000,0,1050000,35
"1284","OR","LAND SLIDE",0,5,2056000,0,2056000,5
"1285","OR","LIGHTNING",1,15,2764500,20000,2784500,16
"1286","OR","MICROBURST",0,0,20000,0,20000,0
"1287","OR","MUD SLIDE",1,2,0,0,0,3
"1288","OR","PRECIPITATION",0,0,5e+05,0,5e+05,0
"1289","OR","RAIN",0,0,79000,4e+06,4079000,0
"1290","OR","RIP CURRENT",3,2,7500000,0,7500000,5
"1291","OR","SLEET",0,0,0,0,0,0
"1292","OR","SMOKE",0,0,1e+05,0,1e+05,0
"1293","OR","SNOW",2,22,170000,0,170000,24
"1294","OR","STORM",0,0,5e+05,0,5e+05,0
"1295","OR","SURF",14,1,1500000,0,1500000,15
"1296","OR","TEMPERATURE_LOW",0,0,0,60000,60000,0
"1297","OR","THUNDERSTORM WIND",1,17,7262250,1060000,8322250,18
"1298","OR","TIDE",0,0,0,0,0,0
"1299","OR","TORNADO",0,5,30858880,23000,30881880,5
"1300","OR","WATERSPOUT",0,0,0,0,0,0
"1301","OR","WEATHER",0,0,0,0,0,0
"1302","OR","WET MICROBURST",0,0,0,0,0,0
"1303","OR","WILD FIRE",0,7,16939000,530400,17469400,7
"1304","OR","WIND",21,51,109590900,5050000,114640900,72
"1305","OR","WINTER STORM",8,14,1085000,0,1085000,22
"1306","OR","WINTER WEATHER",1,2,50000,0,50000,3
"1307","PA","BLIZZARD",11,0,23970000,0,23970000,11
"1308","PA","DROUGHT",0,0,5000,539400000,539405000,0
"1309","PA","DRY",0,0,0,0,0,0
"1310","PA","DUST DEVIL",0,1,5000,0,5000,1
"1311","PA","FLOOD",86,166,2523488008.8,4505000,2527993008.8,252
"1312","PA","FOG",0,16,0,0,0,16
"1313","PA","FREEZE RAIN",2,0,0,0,0,2
"1314","PA","FROST",0,0,0,0,0,0
"1315","PA","FROST FREEZE",0,0,0,0,0,0
"1316","PA","FUNNEL",0,0,0,0,0,0
"1317","PA","FUNNEL CLOUD",0,0,0,0,0,0
"1318","PA","HAIL",0,1,5364600,3487050,8851650,1
"1319","PA","HEAT",514,381,205000,50000,255000,895
"1320","PA","ICE",0,107,555000,0,555000,107
"1321","PA","ICE ROAD",0,2,10000,0,10000,2
"1322","PA","ICE STORM",0,40,51370000,0,51370000,40
"1323","PA","LAND SLIDE",0,0,65000,0,65000,0
"1324","PA","LIGHTNING",26,237,25452925,3e+05,25752925,263
"1325","PA","MICROBURST",0,0,5000,0,5000,0
"1326","PA","OTHER",1,0,0,0,0,1
"1327","PA","PRECIPITATION",0,0,0,0,0,0
"1328","PA","RAIN",3,4,1000,0,1000,7
"1329","PA","SMOKE",0,0,0,0,0,0
"1330","PA","SNOW",5,304,97830000,0,97830000,309
"1331","PA","STORM",0,1,120000,0,120000,1
"1332","PA","TEMPERATURE_HIGH",29,0,0,0,0,29
"1333","PA","TEMPERATURE_LOW",13,129,5495000,5e+07,55495000,142
"1334","PA","THUNDERSTORM",0,9,0,0,0,9
"1335","PA","THUNDERSTORM RAIN",0,0,0,0,0,0
"1336","PA","THUNDERSTORM WIND",27,357,155875300,530000,156405300,384
"1337","PA","TIDE",0,0,0,0,0,0
"1338","PA","TORNADO",82,1241,1789088400,7129000,1796217400,1323
"1339","PA","TROPICAL STORM",2,0,2850000,0,2850000,2
"1340","PA","WATER",0,0,0,0,0,0
"1341","PA","WATERSPOUT",0,0,0,0,0,0
"1342","PA","WET",0,0,0,0,0,0
"1343","PA","WET WEATHER",0,0,0,0,0,0
"1344","PA","WILD FIRE",0,0,1405000,0,1405000,0
"1345","PA","WIND",31,38,84134670,1500,84136170,69
"1346","PA","WINTER SNOW",0,0,0,0,0,0
"1347","PA","WINTER STORM",7,84,48845000,0,48845000,91
"1348","PA","WINTER WEATHER",7,105,1895000,0,1895000,112
"1349","PH","THUNDERSTORM WIND",0,0,0,0,0,0
"1350","PH","WATERSPOUT",0,0,0,0,0,0
"1351","PH","WIND",1,0,0,0,0,1
"1352","PK","THUNDERSTORM WIND",0,0,0,0,0,0
"1353","PK","WATERSPOUT",0,0,0,0,0,0
"1354","PK","WIND",0,0,31000,0,31000,0
"1355","PM","WATERSPOUT",0,0,0,0,0,0
"1356","PR","",0,0,50,0,50,0
"1357","PR","DROUGHT",0,0,5e+06,0,5e+06,0
"1358","PR","DRY SPELL",0,0,0,0,0,0
"1359","PR","DUST",0,0,0,0,0,0
"1360","PR","DUST STORM",0,0,0,0,0,0
"1361","PR","FIRE",0,0,55000,0,55000,0
"1362","PR","FLOOD",45,4,314714200,60570000,375284200,49
"1363","PR","FUNNEL CLOUD",0,0,0,0,0,0
"1364","PR","HAIL",0,0,6500,0,6500,0
"1365","PR","HEAT",0,0,0,0,0,0
"1366","PR","HURRICANE",19,1,124431000,4.51e+08,575431000,20
"1367","PR","LAND SLIDE",3,4,5234500,0,5234500,7
"1368","PR","LIGHTNING",6,4,360000,0,360000,10
"1369","PR","MUD SLIDE",0,0,0,0,0,0
"1370","PR","MUD SLIDE LAND SLIDE",0,0,0,0,0,0
"1371","PR","RAIN",13,10,1685130,1e+05,1785130,23
"1372","PR","RIP CURRENT",10,0,0,0,0,10
"1373","PR","SEICHE",0,0,0,0,0,0
"1374","PR","SHOWER",0,0,500,0,500,0
"1375","PR","STREAM",0,0,5000,0,5000,0
"1376","PR","SURF",11,9,2842000,0,2842000,20
"1377","PR","SWELL",1,0,20000,0,20000,1
"1378","PR","TEMPERATURE",0,0,0,0,0,0
"1379","PR","THUNDERSTORM WIND",0,11,17450110,7000,17457110,11
"1380","PR","TIDE",2,5,0,0,0,7
"1381","PR","TORNADO",0,0,470000,1000,471000,0
"1382","PR","TROPICAL DEPRESSION",0,0,0,0,0,0
"1383","PR","TROPICAL STORM",5,2,73659000,103605000,177264000,7
"1384","PR","VOLCANIC ASH",0,0,3e+05,0,3e+05,0
"1385","PR","VOLCANIC ASH PLUME",0,0,0,0,0,0
"1386","PR","WATERSPOUT",0,0,5500,0,5500,0
"1387","PR","WILD FIRE",0,0,6600000,1165000,7765000,0
"1388","PR","WIND",0,2,365100,0,365100,2
"1389","PZ","THUNDERSTORM WIND",0,0,0,0,0,0
"1390","PZ","WATERSPOUT",0,0,0,0,0,0
"1391","PZ","WIND",5,3,76000,0,76000,8
"1392","RI","BLIZZARD",0,0,10000,0,10000,0
"1393","RI","FLOOD",0,0,93541000,0,93541000,0
"1394","RI","FOG",0,0,0,0,0,0
"1395","RI","FREEZE RAIN",0,0,0,0,0,0
"1396","RI","FUNNEL CLOUD",0,0,0,0,0,0
"1397","RI","HAIL",0,0,20000,0,20000,0
"1398","RI","HEAT",2,0,0,0,0,2
"1399","RI","ICE",0,0,50000,0,50000,0
"1400","RI","ICE STORM",0,0,5e+05,0,5e+05,0
"1401","RI","LIGHTNING",1,17,1508000,0,1508000,18
"1402","RI","RAIN",0,0,30000,0,30000,0
"1403","RI","RIP CURRENT",0,1,0,0,0,1
"1404","RI","SNOW",0,0,11340000,0,11340000,0
"1405","RI","STORM",0,0,0,0,0,0
"1406","RI","SURF",3,0,0,0,0,3
"1407","RI","TEMPERATURE_HIGH",0,0,0,0,0,0
"1408","RI","TEMPERATURE_LOW",0,0,0,0,0,0
"1409","RI","THUNDERSTORM WIND",0,0,2489500,0,2489500,0
"1410","RI","TORNADO",0,23,3545000,0,3545000,23
"1411","RI","TROPICAL STORM",0,0,203000,0,203000,0
"1412","RI","WATERSPOUT",0,0,0,0,0,0
"1413","RI","WAVE",1,0,0,0,0,1
"1414","RI","WIND",0,5,6924500,0,6924500,5
"1415","RI","WINTER STORM",0,2,485000,0,485000,2
"1416","RI","WINTER WEATHER",0,0,0,0,0,0
"1417","SC","DROUGHT",0,0,0,2e+07,2e+07,0
"1418","SC","DRY TEMPERATURE_HIGH WEATHER",0,0,0,0,0,0
"1419","SC","DRY WEATHER",0,0,0,0,0,0
"1420","SC","DUST DEVIL",0,0,10000,0,10000,0
"1421","SC","EROSION",0,0,0,0,0,0
"1422","SC","EROSION FLOOD",0,0,0,0,0,0
"1423","SC","FLOOD",9,19,88060500,15112000,103172500,28
"1424","SC","FOG",1,13,35000,0,35000,14
"1425","SC","FREEZE FOG",0,0,0,0,0,0
"1426","SC","FREEZE RAIN",0,0,1e+05,0,1e+05,0
"1427","SC","FROST FREEZE",0,0,0,1e+06,1e+06,0
"1428","SC","FUNNEL CLOUD",0,0,50000,0,50000,0
"1429","SC","HAIL",1,17,51367000,3715000,55082000,18
"1430","SC","HEAT",41,20,0,0,0,61
"1431","SC","HURRICANE",1,3,29880000,20300000,50180000,4
"1432","SC","HYPOTHERMIA",1,0,0,0,0,1
"1433","SC","ICE ROAD",0,0,0,0,0,0
"1434","SC","ICE STORM",1,24,153207500,0,153207500,25
"1435","SC","LAND SLIDE",0,0,0,0,0,0
"1436","SC","LIGHTNING",24,105,36613500,0,36613500,129
"1437","SC","MUD ROCK SLIDE",0,0,0,0,0,0
"1438","SC","OTHER",0,0,0,0,0,0
"1439","SC","RAIN",1,1,8013500,353000,8366500,2
"1440","SC","RIP CURRENT",19,4,0,0,0,23
"1441","SC","SLEET FREEZE RAIN",0,0,0,0,0,0
"1442","SC","SLEET STORM",0,0,0,0,0,0
"1443","SC","SMOKE",0,0,0,0,0,0
"1444","SC","SNOW",0,0,6890000,5e+06,11890000,0
"1445","SC","STORM",0,0,0,0,0,0
"1446","SC","SURF",1,0,179000,0,179000,1
"1447","SC","TEMPERATURE",7,0,0,0,0,7
"1448","SC","TEMPERATURE_HIGH",0,0,0,0,0,0
"1449","SC","TEMPERATURE_LOW",19,0,0,20050000,20050000,19
"1450","SC","THUNDERSTORM WIND",14,241,51738730,168000,51906730,255
"1451","SC","TIDE",0,0,0,0,0,0
"1452","SC","TORNADO",59,1314,531745190,5266050,537011240,1373
"1453","SC","TROPICAL STORM",0,0,26966750,1e+05,27066750,0
"1454","SC","WATERSPOUT",0,0,0,0,0,0
"1455","SC","WEATHER",3,0,0,0,0,3
"1456","SC","WILD FIRE",0,0,43575000,0,43575000,0
"1457","SC","WIND",18,25,121455220,17156000,138611220,43
"1458","SC","WINTER STORM",0,0,225000,0,225000,0
"1459","SC","WINTER WEATHER",1,0,110000,0,110000,1
"1460","SD","BLIZZARD",6,32,71984920,0,71984920,38
"1461","SD","DROUGHT",0,0,0,0,0,0
"1462","SD","DUST DEVIL",0,0,23500,0,23500,0
"1463","SD","FLOOD",4,5,131828326,79292000,211120326,9
"1464","SD","FOG",2,3,30000,0,30000,5
"1465","SD","FREEZE",0,0,0,0,0,0
"1466","SD","FREEZE FOG",0,0,0,0,0,0
"1467","SD","FREEZE RAIN",0,0,20000,0,20000,0
"1468","SD","FROST",0,0,0,0,0,0
"1469","SD","FUNNEL CLOUD",0,1,0,0,0,1
"1470","SD","HAIL",0,61,97992050,64274050,162266100,61
"1471","SD","HEAT",1,1,110000,0,110000,2
"1472","SD","ICE",0,0,0,0,0,0
"1473","SD","ICE JAM FLOOD",0,0,505000,0,505000,0
"1474","SD","ICE STORM",8,67,18104000,0,18104000,75
"1475","SD","ICE WIND",0,0,3500000,0,3500000,0
"1476","SD","LIGHTNING",5,19,2636150,500,2636650,24
"1477","SD","RAIN",0,4,5780000,5075000,10855000,4
"1478","SD","SNOW",2,86,19641000,20000,19661000,88
"1479","SD","TEMPERATURE_LOW",1,0,0,0,0,1
"1480","SD","THUNDERSTORM WIND",6,111,78138300,22487100,100625400,117
"1481","SD","TORNADO",18,452,231213780,640100,231853880,470
"1482","SD","WILD FIRE",1,1,72000,14000,86000,2
"1483","SD","WIND",6,18,7698650,0,7698650,24
"1484","SD","WINTER STORM",0,7,10952500,0,10952500,7
"1485","SD","WINTER WEATHER",1,0,85000,0,85000,1
"1486","SL","HAIL",0,0,0,0,0,0
"1487","SL","THUNDERSTORM WIND",0,0,15000,0,15000,0
"1488","ST","WIND",0,0,0,0,0,0
"1489","TN","DROUGHT",0,0,0,0,0,0
"1490","TN","DUST DEVIL",0,2,1000,0,1000,2
"1491","TN","FLOOD",59,45,1264892270,5868000,1270760270,104
"1492","TN","FREEZE FOG",0,0,0,0,0,0
"1493","TN","FREEZE RAIN",0,2,40000,0,40000,2
"1494","TN","FROST FREEZE",0,0,0,0,0,0
"1495","TN","FUNNEL CLOUD",0,0,90000,0,90000,0
"1496","TN","HAIL",0,15,13700600,496000,14196600,15
"1497","TN","HEAT",39,1,0,0,0,40
"1498","TN","ICE",0,0,5e+05,0,5e+05,0
"1499","TN","ICE STORM",1,0,797000,0,797000,1
"1500","TN","LIGHTNING",19,108,22893620,30000,22923620,127
"1501","TN","RAIN",1,0,322000,0,322000,1
"1502","TN","SLEET",0,0,0,0,0,0
"1503","TN","SNOW",0,1,5452360,0,5452360,1
"1504","TN","TEMPERATURE_LOW",4,0,0,0,0,4
"1505","TN","THUNDERSTORM WIND",15,253,192658580,9729500,202388080,268
"1506","TN","TORNADO",368,4748,1541799890,2679000,1544478890,5116
"1507","TN","TROPICAL DEPRESSION",0,0,6e+05,0,6e+05,0
"1508","TN","TROPICAL STORM",0,0,235000,0,235000,0
"1509","TN","WILD FIRE",0,0,1e+05,0,1e+05,0
"1510","TN","WIND",11,7,8677850,1846000,10523850,18
"1511","TN","WINTER STORM",3,20,4336040,5e+06,9336040,23
"1512","TN","WINTER WEATHER",1,0,3e+05,0,3e+05,1
"1513","TX","BLIZZARD",0,0,5e+05,0,5e+05,0
"1514","TX","DROUGHT",0,0,349027000,6373438000,6722465000,0
"1515","TX","DRY MICROBURST",0,1,5168000,0,5168000,1
"1516","TX","DUST",0,0,0,0,0,0
"1517","TX","DUST DEVIL",0,0,50000,0,50000,0
"1518","TX","DUST STORM",0,2,835000,3e+06,3835000,2
"1519","TX","FLOOD",254,6926,2165290150,113670000,2278960150,7180
"1520","TX","FOG",0,4,375000,0,375000,4
"1521","TX","FREEZE FOG",0,0,0,0,0,0
"1522","TX","FREEZE RAIN",0,0,5000,0,5000,0
"1523","TX","FROST FREEZE",0,0,40000,1e+07,10040000,0
"1524","TX","FUNNEL",0,0,0,0,0,0
"1525","TX","FUNNEL CLOUD",0,0,0,0,0,0
"1526","TX","GUSTNADO",0,0,0,0,0,0
"1527","TX","HAIL",4,287,3066463550,456694600,3523158150,291
"1528","TX","HEAT",298,787,2e+05,50000,250000,1085
"1529","TX","HURRICANE",6,17,1053140000,0,1053140000,23
"1530","TX","ICE",6,4,6e+05,0,6e+05,10
"1531","TX","ICE FOG",0,0,0,0,0,0
"1532","TX","ICE SNOW",0,0,0,0,0,0
"1533","TX","ICE STORM",15,30,277421000,450000,277871000,45
"1534","TX","LAND SLIDE",0,0,0,0,0,0
"1535","TX","LIGHTNING",57,248,47856660,20050,47876710,305
"1536","TX","OTHER",0,0,0,0,0,0
"1537","TX","RAIN",6,26,1923000,3600000,5523000,32
"1538","TX","RIP CURRENT",21,6,0,0,0,27
"1539","TX","SLEET",0,0,0,0,0,0
"1540","TX","SLEET STORM",0,0,0,0,0,0
"1541","TX","SMOKE",0,0,0,0,0,0
"1542","TX","SNOW",3,1,28295000,3220000,31515000,4
"1543","TX","STORM",11,0,500425000,0,500425000,11
"1544","TX","SURF",2,2,0,0,0,4
"1545","TX","TEMPERATURE_LOW",8,0,2050000,1600000,3650000,8
"1546","TX","THUNDERSTORM",0,0,6505000,0,6505000,0
"1547","TX","THUNDERSTORM WIND",48,733,922797060,85558300,1008355360,781
"1548","TX","TIDE",0,0,0,0,0,0
"1549","TX","TORNADO",538,8207,3720855841,81889100,3802744941,8745
"1550","TX","TROPICAL DEPRESSION",0,0,5000,0,5000,0
"1551","TX","TROPICAL STORM",26,3,341593000,4190000,345783000,29
"1552","TX","WATERSPOUT",0,0,75000,0,75000,0
"1553","TX","WILD FIRE",24,146,606012700,161796400,767809100,170
"1554","TX","WIND",17,57,57911310,1000050,58911360,74
"1555","TX","WINTER STORM",7,5,36214000,693000,36907000,12
"1556","TX","WINTER WEATHER",15,175,9935200,0,9935200,190
"1557","UT","AVALANCHE",44,25,70000,0,70000,69
"1558","UT","BLIZZARD",3,50,4e+07,0,4e+07,53
"1559","UT","DROUGHT",0,0,0,0,0,0
"1560","UT","DRY MICROBURST",2,0,117500,15000,132500,2
"1561","UT","DUST STORM",0,0,0,0,0,0
"1562","UT","FLOOD",12,41,371261503.9,948200,372209703.9,53
"1563","UT","FOG",6,32,1252000,0,1252000,38
"1564","UT","FROST",0,0,0,0,0,0
"1565","UT","FROST FREEZE",0,0,1e+05,0,1e+05,0
"1566","UT","FUNNEL CLOUD",0,0,0,0,0,0
"1567","UT","HAIL",0,8,6374000,203250,6577250,8
"1568","UT","HEAT",1,0,0,0,0,1
"1569","UT","ICE STORM",0,0,0,0,0,0
"1570","UT","LAND SLIDE",0,0,12065500,0,12065500,0
"1571","UT","LIGHTNING",22,50,1435800,50000,1485800,72
"1572","UT","RAIN",0,0,2240900,74800,2315700,0
"1573","UT","SNOW",11,259,54460750,72100,54532850,270
"1574","UT","TEMPERATURE_LOW",0,0,20000,1e+05,120000,0
"1575","UT","THUNDERSTORM",0,0,550,0,550,0
"1576","UT","THUNDERSTORM WIND",3,36,65467600,356300,65823900,39
"1577","UT","TORNADO",1,91,174812920,607700,175420620,92
"1578","UT","WATERSPOUT",0,0,0,0,0,0
"1579","UT","WILD FIRE",10,6,5770000,40000,5810000,16
"1580","UT","WIND",1,57,45984150,2110000,48094150,58
"1581","UT","WINTER STORM",20,415,11822000,298000,12120000,435
"1582","UT","WINTER WEATHER",0,0,20000,0,20000,0
"1583","VA","",0,0,0,0,0,0
"1584","VA","BLIZZARD",1,1,5350000,0,5350000,2
"1585","VA","DROUGHT",2,0,0,297480000,297480000,2
"1586","VA","DRY MICROBURST",0,0,30000,0,30000,0
"1587","VA","DUST DEVIL",0,0,16000,0,16000,0
"1588","VA","FLOOD",49,17,527715932,92610550,620326482,66
"1589","VA","FOG",0,0,8e+05,0,8e+05,0
"1590","VA","FREEZE",0,0,0,17960000,17960000,0
"1591","VA","FREEZE FOG",0,0,0,0,0,0
"1592","VA","FREEZE RAIN",0,0,9000,0,9000,0
"1593","VA","FROST",0,0,0,0,0,0
"1594","VA","FROST FREEZE",0,0,0,4956000,4956000,0
"1595","VA","FUNNEL CLOUD",0,0,0,0,0,0
"1596","VA","HAIL",0,2,61623650,1669600,63293250,2
"1597","VA","HEAT",6,252,50,6e+05,600050,258
"1598","VA","HURRICANE",5,4,635012000,60030000,695042000,9
"1599","VA","ICE",0,0,0,0,0,0
"1600","VA","ICE STORM",0,2,21920000,1275000,23195000,2
"1601","VA","LAND SLIDE",1,0,25000,0,25000,1
"1602","VA","LAND SPOUT",0,0,2000,0,2000,0
"1603","VA","LIGHTNING",22,96,21484825,35500,21520325,118
"1604","VA","MUD SLIDE",0,0,0,0,0,0
"1605","VA","PRECIPITATION",0,0,0,0,0,0
"1606","VA","RAIN",0,0,226000,3e+06,3226000,0
"1607","VA","RIP CURRENT",3,0,0,0,0,3
"1608","VA","ROCK SLIDE",0,0,150000,0,150000,0
"1609","VA","SLEET SNOW",0,0,0,0,0,0
"1610","VA","SNOW",3,1,5990500,5000,5995500,4
"1611","VA","STORM",0,0,1780000,0,1780000,0
"1612","VA","SURF",2,1,80000,0,80000,3
"1613","VA","TEMPERATURE",0,0,0,0,0,0
"1614","VA","TEMPERATURE_HIGH",0,12,0,0,0,12
"1615","VA","TEMPERATURE_LOW",4,0,30000,1150000,1180000,4
"1616","VA","THUNDERSTORM WIND",11,185,77512600,3029550,80542150,196
"1617","VA","TIDE",2,0,0,0,0,2
"1618","VA","TORNADO",36,914,439239250,2156000,441395250,950
"1619","VA","TROPICAL STORM",5,29,107853500,17600000,125453500,34
"1620","VA","WATERSPOUT",0,0,0,0,0,0
"1621","VA","WET MICROBURST",0,0,15000,0,15000,0
"1622","VA","WILD FIRE",0,4,4209000,1700200,5909200,4
"1623","VA","WIND",14,121,75294000,19991000,95285000,135
"1624","VA","WINTER STORM",3,11,20196000,25000,20221000,14
"1625","VA","WINTER WEATHER",5,51,10000,0,10000,56
"1626","VI","DROUGHT",0,0,0,2e+05,2e+05,0
"1627","VI","DUST",0,0,0,0,0,0
"1628","VI","DUST STORM",0,0,0,0,0,0
"1629","VI","FLOOD",0,0,3485000,0,3485000,0
"1630","VI","FUNNEL CLOUD",0,0,0,0,0,0
"1631","VI","HAIL",0,0,0,0,0,0
"1632","VI","HURRICANE",0,0,28220000,0,28220000,0
"1633","VI","LIGHTNING",1,1,61500,0,61500,2
"1634","VI","RAIN",0,0,5e+05,0,5e+05,0
"1635","VI","RIP CURRENT",2,1,0,0,0,3
"1636","VI","SURF",3,0,10000,0,10000,3
"1637","VI","SWELL",0,0,0,0,0,0
"1638","VI","TEMPERATURE",0,0,0,0,0,0
"1639","VI","THUNDERSTORM WIND",0,0,77300,0,77300,0
"1640","VI","TIDE",1,0,15000,0,15000,1
"1641","VI","TROPICAL DEPRESSION",0,0,0,0,0,0
"1642","VI","TROPICAL STORM",0,0,6250000,5000,6255000,0
"1643","VI","VOLCANIC ASH",0,0,2e+05,0,2e+05,0
"1644","VI","WATERSPOUT",0,0,0,0,0,0
"1645","VI","WILD FIRE",0,0,222000,0,222000,0
"1646","VI","WIND",0,0,531500,0,531500,0
"1647","VT","BLIZZARD",0,0,5e+05,0,5e+05,0
"1648","VT","DROUGHT",0,0,0,0,0,0
"1649","VT","FLOOD",7,5,1428573500,26675000,1455248500,12
"1650","VT","FOG",0,0,45000,0,45000,0
"1651","VT","FREEZE",0,0,0,0,0,0
"1652","VT","FREEZE RAIN",0,0,1142000,0,1142000,0
"1653","VT","FROST",0,0,0,5e+06,5e+06,0
"1654","VT","FROST FREEZE",0,0,0,50000,50000,0
"1655","VT","FUNNEL CLOUD",0,0,0,0,0,0
"1656","VT","HAIL",0,0,456000,260000,716000,0
"1657","VT","HEAT",0,0,0,0,0,0
"1658","VT","ICE STORM",0,1,6230000,0,6230000,1
"1659","VT","LIGHTNING",3,9,5574500,0,5574500,12
"1660","VT","MIX",0,0,1100000,0,1100000,0
"1661","VT","PRECIPITATION",0,0,531000,0,531000,0
"1662","VT","RAIN",0,0,160000,0,160000,0
"1663","VT","SMOKE",0,0,0,0,0,0
"1664","VT","SNOW",3,2,8591000,0,8591000,5
"1665","VT","TEMPERATURE",0,0,0,0,0,0
"1666","VT","TEMPERATURE_HIGH",0,0,0,0,0,0
"1667","VT","TEMPERATURE_LOW",0,0,5e+05,0,5e+05,0
"1668","VT","THUNDERSTORM WIND",3,34,16493000,250000,16743000,37
"1669","VT","TORNADO",0,10,5449750,75000,5524750,10
"1670","VT","TROPICAL STORM",0,0,0,0,0,0
"1671","VT","WIND",3,4,11872900,285000,12157900,7
"1672","VT","WINTER STORM",2,6,15564650,70000,15634650,8
"1673","VT","WINTER WEATHER",2,0,2660000,0,2660000,2
"1674","WA","AVALANCHE",35,36,2100000,0,2100000,71
"1675","WA","BLIZZARD",3,1,16000,0,16000,4
"1676","WA","DROUGHT",0,0,1.2e+07,0,1.2e+07,0
"1677","WA","DRY MICROBURST",0,0,48000,0,48000,0
"1678","WA","DUST DEVIL",0,0,10000,0,10000,0
"1679","WA","DUST STORM",1,43,95000,0,95000,44
"1680","WA","FLOOD",9,2,234070000,10000,234080000,11
"1681","WA","FOG",1,4,190000,0,190000,5
"1682","WA","FREEZE FOG",0,0,2e+06,0,2e+06,0
"1683","WA","FREEZE RAIN",2,21,6e+05,0,6e+05,23
"1684","WA","FROST FREEZE",0,0,0,205020000,205020000,0
"1685","WA","FUNNEL CLOUD",0,0,2000,0,2000,0
"1686","WA","HAIL",0,13,10403500,209501000,219904500,13
"1687","WA","HEAT",3,0,0,0,0,3
"1688","WA","ICE",4,72,5600000,0,5600000,76
"1689","WA","ICE STORM",2,5,2066000,5700000,7766000,7
"1690","WA","LAND SLIDE",1,2,43532000,17000,43549000,3
"1691","WA","LIGHTNING",3,26,2971800,1e+05,3071800,29
"1692","WA","MUD SLIDE",4,0,2e+05,0,2e+05,4
"1693","WA","RAIN",1,37,189855500,22090000,211945500,38
"1694","WA","RIP CURRENT",1,0,0,0,0,1
"1695","WA","SNOW",8,61,52041000,0,52041000,69
"1696","WA","STORM",0,1,1905000,0,1905000,1
"1697","WA","SURF",3,0,0,0,0,3
"1698","WA","TEMPERATURE_LOW",3,0,0,65050000,65050000,3
"1699","WA","THUNDERSTORM",0,0,0,0,0,0
"1700","WA","THUNDERSTORM WIND",2,25,3874500,7432000,11306500,27
"1701","WA","TIDE",0,0,90000,0,90000,0
"1702","WA","TORNADO",6,303,29017280,0,29017280,309
"1703","WA","VOLCANIC ASH",0,0,0,0,0,0
"1704","WA","WATERSPOUT",0,0,0,0,0,0
"1705","WA","WILD FIRE",4,12,28416500,82759000,111175500,16
"1706","WA","WIND",45,81,161026200,30263000,191289200,126
"1707","WA","WINTER STORM",4,1,1978000,0,1978000,5
"1708","WA","WINTER WEATHER",1,7,718000,0,718000,8
"1709","WI","BLIZZARD",1,5,11000,0,11000,6
"1710","WI","DROUGHT",0,0,0,4526000,4526000,0
"1711","WI","DRY",0,0,0,0,0,0
"1712","WI","DRY MICROBURST",0,2,0,0,0,2
"1713","WI","DUST DEVIL",0,0,8200,0,8200,0
"1714","WI","FLOOD",10,19,986565750,817578500,1804144250,29
"1715","WI","FOG",12,2,20000,0,20000,14
"1716","WI","FREEZE RAIN",0,0,0,0,0,0
"1717","WI","FROST FREEZE",0,0,0,2000,2000,0
"1718","WI","FUNNEL",0,0,0,0,0,0
"1719","WI","FUNNEL CLOUD",0,0,0,0,0,0
"1720","WI","HAIL",0,41,961723350,56132850,1017856200,41
"1721","WI","HEAT",98,149,37000,0,37000,247
"1722","WI","ICE",0,0,40000,0,40000,0
"1723","WI","ICE SNOW",0,0,0,0,0,0
"1724","WI","ICE STORM",0,15,536500,0,536500,15
"1725","WI","LIGHTNING",12,120,60756350,228000,60984350,132
"1726","WI","OTHER",0,0,0,0,0,0
"1727","WI","PRECIPITATION",0,0,0,0,0,0
"1728","WI","RAIN",0,2,1650000,53000,1703000,2
"1729","WI","SEICHE",0,0,0,0,0,0
"1730","WI","SNOW",1,23,195000,0,195000,24
"1731","WI","TEMPERATURE_HIGH",0,0,0,0,0,0
"1732","WI","TEMPERATURE_LOW",13,52,30000,0,30000,65
"1733","WI","THUNDERSTORM WIND",13,226,254333000,43319750,297652750,239
"1734","WI","TORNADO",96,1601,958093080,16513700,974606780,1697
"1735","WI","WATERSPOUT",0,0,0,0,0,0
"1736","WI","WILD FIRE",1,3,2237000,502000,2739000,4
"1737","WI","WIND",22,40,19782050,1580000,21362050,62
"1738","WI","WINTER STORM",0,7,621000,0,621000,7
"1739","WI","WINTER WEATHER",0,2,610800,1.5e+07,15610800,2
"1740","WV","BLIZZARD",3,0,555000,0,555000,3
"1741","WV","DROUGHT",0,0,0,19746000,19746000,0
"1742","WV","DRY PATTERN",0,0,0,0,0,0
"1743","WV","DUST DEVIL",0,0,1000,0,1000,0
"1744","WV","FIRE",0,0,0,0,0,0
"1745","WV","FLOOD",42,12,786398100,2400000,788798100,54
"1746","WV","FOG",0,0,0,0,0,0
"1747","WV","FREEZE",0,0,0,9380000,9380000,0
"1748","WV","FREEZE FOG",0,0,0,0,0,0
"1749","WV","FREEZE RAIN",0,0,50000,0,50000,0
"1750","WV","FROST",0,0,0,0,0,0
"1751","WV","FROST FREEZE",0,0,0,0,0,0
"1752","WV","FUNNEL CLOUD",0,0,0,0,0,0
"1753","WV","HAIL",0,3,25632000,127000,25759000,3
"1754","WV","HEAT",1,3,0,0,0,4
"1755","WV","ICE",0,0,0,0,0,0
"1756","WV","ICE STORM",1,0,10459000,0,10459000,1
"1757","WV","LAND SLIDE",0,0,105000,0,105000,0
"1758","WV","LIGHTNING",6,48,3490700,0,3490700,54
"1759","WV","NORTHERN",0,0,0,0,0,0
"1760","WV","OTHER",0,0,5000,0,5000,0
"1761","WV","PATTERN",0,0,0,0,0,0
"1762","WV","PRECIPITATION",0,0,0,0,0,0
"1763","WV","RAIN",10,1,220000,0,220000,11
"1764","WV","SNOW",6,8,68887000,0,68887000,14
"1765","WV","TEMPERATURE",0,0,0,0,0,0
"1766","WV","TEMPERATURE_HIGH",0,3,0,0,0,3
"1767","WV","TEMPERATURE_LOW",3,5,5130000,20000,5150000,8
"1768","WV","THUNDERSTORM",0,0,5000,0,5000,0
"1769","WV","THUNDERSTORM WIND",12,151,32109050,60000,32169050,163
"1770","WV","TORNADO",3,114,36708870,2306000,39014870,117
"1771","WV","WATER",2,0,505000,0,505000,2
"1772","WV","WATERSPOUT",0,0,0,0,0,0
"1773","WV","WILD FIRE",1,0,23000,0,23000,1
"1774","WV","WIND",2,9,5956700,790100,6746800,11
"1775","WV","WINTER STORM",0,6,15450500,10000,15460500,6
"1776","WV","WINTER WEATHER",0,0,60000,0,60000,0
"1777","WY","AVALANCHE",23,21,15000,0,15000,44
"1778","WY","BLIZZARD",1,0,7487000,10000,7497000,1
"1779","WY","DRY MICROBURST",0,11,535000,0,535000,11
"1780","WY","DUST DEVIL",1,0,2000,0,2000,1
"1781","WY","FLOOD",6,6,25941800,1172050,27113850,12
"1782","WY","FOG",0,5,46000,0,46000,5
"1783","WY","FUNNEL CLOUD",0,0,0,0,0,0
"1784","WY","HAIL",0,14,111222200,1881200,113103400,14
"1785","WY","ICE ROAD",2,8,162000,0,162000,10
"1786","WY","ICE STORM",0,0,0,0,0,0
"1787","WY","LAND SLIDE",0,0,1227000,0,1227000,0
"1788","WY","LIGHTNING",8,72,1170000,91000,1261000,80
"1789","WY","RAIN",0,0,3500,0,3500,0
"1790","WY","SNOW",1,3,13000,0,13000,4
"1791","WY","TEMPERATURE_LOW",1,0,50000,150000,2e+05,1
"1792","WY","THUNDERSTORM WIND",0,43,3641700,10000,3651700,43
"1793","WY","TORNADO",4,101,47617110,0,47617110,105
"1794","WY","WILD FIRE",1,11,4301000,0,4301000,12
"1795","WY","WIND",2,18,2819100,25900,2845000,20
"1796","WY","WINTER STORM",6,119,2508000,0,2508000,125
"1797","WY","WINTER WEATHER",0,0,20000,0,20000,0
"1798","XX","THUNDERSTORM WIND",0,0,0,0,0,0
